Filipinas	-ina	Felipe
Senegambia	Senegal	Gambia
abatidamente	abatido	mente
abdicativamente	abdicativo	mente
aberrante	aberrar	nte
abertzalismo	abertzale	ismo
aberzalismo	aberzale	ismo
abiertamente	abierto	mente
abiogénesis	a	bio	génesis
abnegadamente	abnegado	mente
abogacil	abogacía	il
abominablemente	abominable	mente
abondadamente	abondado	mente
aborreciblemente	aborrecible	mente
abrazadera	abrazar	dero
abrumadoramente	abrumador	mente
abruptamente	abrupto	mente
abstinente	-nte	abstener
abstraccionismo	abstracción	ismo
abstractamente	abstracto	mente
abstractismo	abstracto	ismo
absurdamente	absurdo	mente
abuelastro	abuelo	astro
acaricida	-cida	ácaro
acarología	-logía	ácaro
acarológico	acarología	-́ico
acatable	acatar	ble
accidentalmente	accidental	mente
accidentariamente	accidentario	mente
accidentología	accidente	logía
acedamente	acedo	mente
aceptablemente	aceptable	mente
acertadamente	acertado	mente
acertar	a	certum
acetificar	acetum	ficar
acidemia	ácido	-emia
acidificar	-ficar	ácido
acidimetría	-metría	ácido
acidulante	acidular	nte
aciduria	ácido	-uria
acongojadamente	acongojado	mente
aconsejar	a	consejo
acordemente	acorde	mente
acreditante	acreditar	nte
acrónimo	acro	ónimo
activamente	activo	mente
actualmente	actual	mente
acuciosamente	acucioso	mente
acudiente	acudir	nte
acudir	acorrer	recudir
acuicultura	acui	cultura
acuradamente	acurado	mente
adecuadamente	adecuado	mente
adelgazante	adelgazar	nte
adenocarcinoma	adeno	carcinoma
adenoideo	adeno	oide
adenológico	adenología	-́ico
adenoma	adeno	ma
adherente	adherir	nte
adicionalmente	adicional	mente
admirablemente	admirable	mente
adoleciente	adolecer	nte
adoptante	adoptar	nte
adorablemente	adorable	mente
adorante	adorar	nte
adulterante	adulterar	nte
adverbializar	adverbial	izar
aeriforme	aer	forme
aerobio	aero	bio
aerobiología	aero	biología
aerobiológico	aerobiología	-́ico
aerocomercial	aero	comercial
aerocriptografía	aero	criptografía
aerofagia	aero	fagia
aerofaro	aero	faro
aerofobia	aero	fobia
aerofotografía	aero	fotografía
aerogenerador	aero	generador
aerograma	aero	grama
aerográfico	aerografía	-́ico
aerolito	aero	lito
aerológico	aerología	-́ico
aeromodelo	aero	modelo
aeronave	aero	nave
aeropalinológico	-́ico	aeropalinología
aerostación	statio	aero-
aeroterapia	aero	terapia
aerotécnico	aerotecnia	-́ico
aeródromo	δρόμος	aero-
aerófono	-́fono	aero-
aerógrafo	-́grafo	aero-
aerómetro	-́metro	aero-
afablemente	afable	mente
afanita	-ita	ἀφανής
afaníptero	-́ptero	ἀφανής
afebril	a	febril
aferrar	a	ferro
afligidamente	afligido	mente
afluente	afluir	nte
afluentemente	afluente	mente
aforar	fuero	a-	foro
afrentosamente	afrentoso	mente
afroamericano	afro	americano
afrodescendiente	afro	descendiente
afónico	-́ico	afonía
agitadamente	agitado	mente
aglomerante	aglomerar	nte
agnosticismo	-ismo	agnóstico
agnóstico	-́ico	ἄγνωστος
agobiante	agobiar	nte
agonizante	agonizar	nte
agradablemente	agradable	mente
agravante	agravar	nte
agraviante	agraviar	nte
agresivamente	agresivo	mente
agriotipo	tipo	ἄγριος
agroalimentario	agro	alimentario
agrocombustible	agro	combustible
agroecología	agro	ecología
agroecológico	-́ico	agroecología
agrología	agro	logía
agrológico	agrología	-́ico
agronegocio	agro	negocio
agronómico	agronomía	-́ico
agropecuario	agro	pecuario
agrostológico	agrostología	-́ico
agujero	aguja	ero
al	a	el
alabable	alabar	ble
albuminoideo	albúmina	-oide
alcalemia	álcali	-emia
alcalifaje	alcalifa	aje
alcoholemia	alcohol	-emia	اَلْكُحُلْ
alectomancia	ἀλέκτωρ	-mancia
alegador	alegar	dor
alegóricamente	alegórico	mente
alelopático	alelopatía	-́ico
alergológico	alergología	-́ico
aletargador	aletargar	dor
alfabetizable	alfabetizar	ble
alfabetizar	alfabeto	izar
alfalfal	alfalfa	al
alfalfar	alfalfa	ar
alfanumérico	numérico	alfabético
alfombrilla	alfombra	illo
algológico	algología	-́ico
alguicida	alga	cida
aliadofilia	aliado	filia
aliñar	lineo	a-
almendral	almendro	-al
almirantazgo	almirante	azgo
alogénico	alo	génico
alotropía	τρόπος	-ía	alo-
alperujo	alpechín	orujo
altamente	alto	mente
altimetría	alti	metría
altiplanicie	alti	planicie
altiplano	alti	plano
altisonante	alti	sonante
alucinante	alucinar	nte
aluminotermia	aluminio	termia
alunizar	a	Luna	izar
alérgeno	alergia	-́geno
amablemente	amable	mente
amarar	a	mar
amarillejo	amarillo	ejo
amarizar	mar	izar
amartizar	a	Marte	izar
amaxofobia	ἅμαξα	-fobia
amazacotado	a	mazacote	ado
ambientalista	ambiental	ista
amebicida	ameba	cida
americanizante	americanizar	nte
amigablemente	amigable	mente
amigdalitis	amígdala	-itis
amigovio	amigo	novio
amorío	amor	ío
ampelográfico	ampelografía	-́ico
ampelología	-logía	ἄμπελος
amperímetro	amperio	-́metro
ampliamente	amplio	mente
analfabetismo	analfabeto	ismo
analista	anales	ista
analógicamente	analógico	mente
anarquizante	anarquizar	nte
andante	andar	nte
androgénesis	andro	génesis
androgénico	andrógeno	-́ico
andrología	andro	logía
andrológico	andrología	-́ico
anemográfico	anemografía	-́ico
anemoscopio	anemo	scopio
anepigráfico	a	epigráfico
anestesiológico	anestesiología	-́ico
angelicalmente	angelical	mente
angelizar	ángel	-izar
angelología	angelus	logía
angelológico	angelología	-́ico
angiografía	angio	grafía
angiográfico	angiografía	-́ico
angiogénesis	angio	génesis
angiología	angio	logía
angiológico	angiología	-́ico
angioma	angio	ma
angioplastia	angio	plastia
angioplástico	angioplastia	-́ico
anglohablante	anglo	hablante
angloparlante	anglo	parlante
anglómano	-́mano	anglo-
angularmente	angular	mente
animalizar	animal	izar
anonadante	anonadar	nte
anormal	a	normal
anormalmente	anormal	mente
anortografía	a	ortografía
anortosita	anortosa	ita
anquirredondo	anca	redondo
antecedente	anteceder	nte
antecológico	-́ico	antecología
antecámara	ante	cámara
anteislámico	ante	islámico
antejuicio	ante	juicio
antemuro	ante	muro
antepospretérito	ante	pospretérito
anteriormente	anterior	mente
antiaéreo	anti	aéreo
antibelicista	anti	belicista
antibélico	anti	bélico
anticiclónico	anticiclón	́ico
anticonceptivo	anti	conceptivo
anticristiano	anti	cristiano
antiguamente	antiguo	mente
antigénico	antígeno	-́ico
antihelmíntico	ἕλμινς	anti-	-́ico
antihorario	anti	horario
antilógico	anti	lógico
antisovietismo	-ismo	sóviet	anti-
antituberculoso	anti	tuberculoso
antitusígeno	anti	tusígeno
antiácido	anti	ácido
antologador	antologar	dor
antologista	antología	ista
antracológico	-́ico	antracología
antropográfico	-́ico	antropografía
antropogénesis	antropo	génesis
antropomorfismo	antropomorfo	ismo
antropomorfizar	antropomorfo	izar
antropopiteco	antropo-	πίθηκος
antófago	-́fago	ἄνθος
anualmente	anual	mente
anunciante	anunciar	nte
anórquido	ὄρχις	a-
apabullante	apabullar	nte
aparatológico	aparatología	-́ico
apasionante	apasionar	nte
apicultor	apis	cultor
apicultura	apis	cultura
aplazar	plaza	a-	plazo
apológico	apólogo	-́ico
apopléjico	apoplejía	-́ico
apremiante	apremiar	nte
apremiantemente	apremiante	mente
aracnológico	aracnología	-́ico
arbitrista	arbitrio	ista
arboricidio	arbori	cidio
arboricultura	arbori	cultura
arboriforme	arbori	forme
arborización	arborizar	ción
arborizar	arbor	izar
arcangélico	arcángel	-́ico
archiconocido	archi	conocido
archifonema	archi	fonema
archivológico	archivología	-́ico
arcontología	arconte	logía
arcontológico	arcontología	-́ico
arcosegundo	arco	segundo
arepazo	arepa	azo
aretológico	aretología	-́ico
areómetro	ἀραιός	-́metro
argentífero	-́fero	argentum
argumentalmente	argumental	mente
argéntico	argentum	-́ico
armoniosamente	armonioso	mente
armonista	armonía	ista
armónicamente	armónico	mente
aromaterapia	-terapia	ἄρωμα
aromatizante	aromatizar	nte
arqueolítico	arqueo	lítico
arqueozoología	arqueo	zoología
arquetípico	arquetipo	-́ico
arquíptero	arqui-	-́ptero
arraigar	a	raigar
arrasadoramente	arrasador	mente
arrozal	arroz	al
arteriográfico	arteriografía	-́ico
arteriología	arteria	logía
arteriológico	arteriología	-́ico
artificialmente	artificial	mente
artralgia	ἄρθρον	-algia
artrografía	-grafía	ἄρθρον
artrográfico	artrografía	-́ico
artrológico	artrología	-́ico
artrópodo	ἄρθρον	-́podo
ascensionista	ascensión	ista
ascetismo	asceta	ismo
aseador	asear	dor
asfáltico	asfalto	-́ico
asfíxico	asfixia	-́ico
asiriológico	asiriología	-́ico
asiriólogo	Asiria	-́logo
asoladoramente	asolador	mente
aspirante	aspirar	nte
astrobiología	astro	biología
astrobiológico	-́ico	astrobiología
astrogeológico	astrogeología	-́ico
astrografía	astro	grafía
astrográfico	astrografía	-́ico
atavismo	atavus	ismo
atelectasia	ἀτελής	ἔκτασις
atmosférico	atmósfera	-́ico
atomizar	átomo	-izar
atorar	a-	tuero
attoamperio	atto	amperio
attocandela	atto	candela
attovatio	atto	vatio
atómico	átomo	-́ico
audiología	audio	logía
audiológico	audiología	-́ico
audífono	-́fono	audio
audímetro	-́metro	audio
aullante	aullar	nte
aurívoro	aurum	-́voro
autentificar	-ficar	auténtico
autobiografía	auto	biografía
autobiográfico	autobiografía	-́ico
autoconsumo	auto	consumo
autodeterminación	auto	determinación
autoescuela	auto	escuela
autoferro	auto	ferro
autogobierno	auto	gobierno
autogolpe	auto	golpe
autografía	auto	grafía
autográfico	-́ico	autografía
autolatría	auto	latría
autolimpiable	auto	limpiable
automáticamente	automático	mente
automóvil	auto	móvil
autopista	auto	pista
autorizar	autor	izar
autoservicio	auto	servicio
autovía	auto	vía
autógeno	auto-	-́geno
aventadura	aventar	dura
avicultura	avis	cultura
ayudista	ayuda	ista
azeuxis	ζεῦξις	a-
babirusa	بابي	babi	روسا	rusa
bachatear	bachata	ear
bactericida	bacteria	cida
bacteriología	bacteria	logía
bacteriológico	bacteriología	-́ico
baipasear	baipás	ear
balneoterapia	balneum	terapia
balístico	balista	-́ico
bancocracia	banco	cracia
barisfera	σφαῖρα	βαρύς
barraquista	barraca	ista
basquetbolista	-ista	básquetbol
batiente	batir	nte
batimetría	-metría	βαθύς
batolito	βάθος	-lito
beatíficamente	beatífico	mente
beneficioso	beneficio	oso
berenjenal	berenjena	al
betlemítico	-́ico	betlemita
bianual	bi	anual
biatleta	bi	atleta
biauricular	bi	auricular
bibliofilia	biblio	filia
bibliografía	biblio	grafía
bibliográfico	bibliografía	-́ico
bibliología	biblio	logía
bibliológico	bibliología	-́ico
bibliomancia	biblio	mancia
bibliomántico	bibliomancia	-́ico
biblioteca	biblio	teca
bibliotecología	biblioteca	logía
biconvexo	bi	convexo
bicromía	χρῶμα	bi-
bicóncavo	bi	cóncavo
bidimensional	bi	dimensional
bienestar	bien	estar
bienfacer	bien	facer
bigamia	bi	gamia
bilateral	bi	lateral
bilocular	bi	loculus	ar
biobibliografía	bio	bibliografía
biocapacidad	bio	capacidad
biocarburante	bio	carburante
biocombustible	bio	combustible
biocompatibilidad	bio	compatibilidad
biodegradable	bio	degradable
biodinámico	bio	dinámico
bioelemento	bio	elemento
bioenergética	bio	energético
bioenergético	bio	energético
bioestratigrafía	bio	estratigrafía
biofertilizante	bio	fertilizante
biogeográfico	biogeografía	-́ico
biogás	bio	gas
biogénesis	bio	génesis
biológicamente	biológico	mente
biológico	biología	-́ico
biomasa	bio	masa
biomaterial	bio	material
biometano	bio	metano
biotecnológico	-́ico	biotecnología
bioterapia	bio	terapia
bisabuelo	bis	abuelo
bisexual	bi	sexual
blandamente	blando	mente
blastodermo	-dermo	βλαστός
blefaroplastia	βλέφαρον	-plastia
bluyín	blue	jeans
bogavante	bogavante	lobagante	avante	bogar
bondadoso	bondad	oso
bonificar	bonus	ficar
boquifruncido	boca	fruncir
boquihundido	boca	hundir
boquimuelle	muelle	boca
boquinatural	boca	natural
boquisumido	sumir	boca
bradicardia	bradi-	καρδία
braquigrafía	βραχύς	-grafía
braquigráfico	-́ico	braquigrafía
braquilógico	-́ico	braquilogía
brevemente	breve	mente
bricbarca	brig	barca
brillantez	brillante	ez
brodista	brodio	ista
bromatológico	bromatología	-́ico
bromista	broma	ista
broncorragia	βρόγχος	-rragia
broncoscopizar	broncoscopio	izar
bronquiectasia	βρόγχος	ἔκτασις
bufonizar	bufón	izar
bárico	-́ico	bar
básicamente	básico	mente
cabañuelas	cabaña	uelo
cabildante	cabildo	nte
cablegráfico	cablegrafía	-́ico
cabrilla	cabra	illo
cachimbear	cachimba	ear
cacofónico	cacofonía	-́ico
cadavérico	cadáver	-́ico
caficultura	café	cultura
cajista	caja	ista
calafatear	calafate	ear
calcografía	-grafía	χαλκός
calculista	-ista	cálculo
calefactable	calefactar	ble
caligráfico	caligrafía	-́ico
callicida	callo	cida
calvez	calvo	ez
calóptero	-́ptero	καλός
cambiante	cambiar	nte
caminante	caminar	nte
campanológico	campanología	-́ico
campanólogo	campana	-́logo
campímetro	campo	-́metro
canaleta	canal	ete
cancioneril	cancionero	il
canelar	canela	ar
canibalizar	-izar	caníbal
canonizable	canonizar	ble
capricultura	capra	cultura
caquéxico	caquexia	-́ico
caramelizar	caramelo	izar
carbizo	carba	izo
carbohidrato	carbono	hidrato
carboxílico	carboxilo	-́ico
carbógeno	carbono	-́geno
carbónico	carbono	-́ico
cardiocirculatorio	cardio	circulatorio
cardiocirugía	cardio	cirugía
cardiocirujano	cardio	cirujano
cardiografía	cardio	grafía
cardiograma	cardio	grama
cardiología	cardio	logía
cardiológico	-́ico	cardiología
cardiopatía	cardio	patía
cardiopulmonar	cardio	pulmonar
cardiorrespiratorio	cardio	respiratorio
cardiotónico	cardio	tónico
cardiópata	cardio-	-́pata
cariotipo	κάρυον	τύπος
carminativo	carminar	ivo
carpológico	carpología	-́ico
carpófago	καρπός	-́fago
carroceta	-ete	carroza
carrozable	carroza	ble
cartografía	carta	grafía
cartográfico	cartografía	-́ico
cartomancia	carta	mancia
cartomántico	cartomancia	-́ico
cartométrico	cartometría	-́ico
cartómetro	carta	-́metro
casamiento	casar	miento
casamuro	casa	muro
caseína	-ina	caseus
catafóricamente	catafórico	mente
catastrófico	-́ico	catástrofe
catoptromancia	-mancia	κάτοπτρον
caudal	cauda	al
caudalímetro	caudal	-́metro
causante	causar	nte
cautelarmente	cautelar	mente
cautelosamente	cauteloso	mente
cañacoro	caña	ácoro
cañamiza	-izo	cáñamo
cañicultura	caña	cultura
cañuela	caña	uelo
cebollar	cebolla	ar
cecografía	-grafía	caecus
cedróleo	cedro	óleo
cefalorraquídeo	cefalo	raquídeo
cefalotórax	cefalo	tórax
celeminear	celemín	ear
celestialmente	celestial	mente
cementante	cementar	nte
centiamperio	centi	amperio
centicandela	centi	candela
centilitro	centi	litro
centivatio	centi	vatio
centímetro	centi-	-́metro
cerrajero	cerrajería	ero
cerrilmente	cerril	mente
chantajista	chantaje	ista
charlador	charlar	dor
charladuría	charlador	ía
charlatanear	charlatán	ear
charlatanería	charlatán	ería
charlatanismo	charlatán	ismo
charlear	charla	ear
chicoriáceo	chicoria	áceo
chiripazo	chiripa	azo
chiriviscal	chirivisco	al
chirriante	chirriar	nte
chismografía	chisme	grafía
chocante	chocar	nte
churrete	churre	ete
churretón	churrete	ón
ciberacosador	ciber	acosador
ciberacoso	ciber	acoso
ciberarte	ciber	arte
ciberataque	ciber	ataque
cibercafé	ciber	café
cibercultura	ciber	cultura
ciberdelincuencia	ciber	delincuencia
ciberdelincuente	ciber	delincuente
ciberdelito	ciber	delito
cicatrizante	cicatrizar	nte
ciclotimia	θυμός	κύκλος
ciclóstoma	κύκλος	στόμα
cienciológico	cienciología	-́ico
cienoso	cieno	oso
ciertamente	cierto	mente
cilíndrico	cilindro	-́ico
cinematográfico	cinematografía	-́ico
cinemómetro	κίνημα	-́metro
cinológico	cinología	-́ico
circumpolar	circun	polar
circunsolar	circun	solar
citodiagnóstico	cito	diagnóstico
citoesqueleto	cito	esqueleto
citogenética	cito	genética
citología	cito	logía
citológico	citología	-́ico
citoplasma	cito	plasma
clandestinamente	clandestino	mente
claramente	claro	mente
clarísimamente	claro	-mente
clavicímbalo	clave	címbalo
clavillo	clavo	illo
cleptocracia	clepto	cracia
cleptomanía	clepto	manía
clientelar	clientela	ar
climatológico	climatología	-́ico
clorhídrico	cloro	hídrico
clorito	cloro	ito
clorofílico	-́ico	clorofila
clorofórmico	cloroformo	-́ico
clástico	κλαστός	-́ico
coagulante	coagular	nte
coalicionista	coalición	ista
cobaltoterapia	cobalto	terapia
cocainomanía	-manía	cocaína
cochastro	cocho	astro
cocotológico	-́ico	cocotología
coexistente	coexistir	nte
coexistir	con	existir
cofrade	frater	cum
colaborativamente	colaborativo	mente
colecistectomía	κύστις	χολή	-ectomía
colegislador	con	legislador
colemia	χολή	-emia
colesterolemia	colesterol	emia
colinabo	col	nabo
colodrillo	colodra	illo
colombicultura	columba	-cultura
colostómico	colostomía	-́ico
colágeno	κόλλα	-́geno
comadrear	comadre	ear
combatiente	combatir	nte
comensal	con	mensa
comercializar	comercial	izar
comerciante	comerciar	nte
completamente	completo	mente
concatedral	con	catedral
concatedralidad	con	catedralidad
conceptualmente	conceptual	mente
conciudadano	con	ciudadano
concordemente	concorde	mente
concorpóreo	con	corpóreo
concretamente	concreto	mente
concursante	concursar	nte
condrografía	-grafía	χόνδρος
condrología	-logía	χόνδρος
condroma	-ma	χόνδρος
conductismo	conducta	ismo
conferenciante	conferenciar	nte
conferencista	conferencia	ista
confortablemente	confortable	mente
confusamente	confuso	mente
conjuntamente	conjunto	mente
conque	con	que
conquiliológico	-́ico	conquiliología
consecuentemente	consecuente	mente
conservante	conservar	nte
considerable	considerar	ble
considerablemente	considerable	mente
conspiranoia	conspiración	paranoia
conspiranoico	conspirativo	paranoico
constantemente	constante	mente
constreñimiento	constreñir	miento
consultante	consultar	nte
contaminante	contaminar	nte
contendiente	-nte	contender
contraamura	contra	amura
contraaproches	contra	aproches
contraatacar	contra	atacar
contrabarrera	contra	barrera
contracambio	contra	cambio
contracandela	contra	candela
contracarta	contra	carta
contracifra	contra	cifra
contracurva	contra	curva
contraescotín	contra	escotín
contraescritura	contra	escritura
contraindicante	contraindicar	nte
contraindicar	contra	indicar
contrainforme	contra	informe
contramuralla	contra	muralla
contramuro	contra	muro
contranatural	contra	natural
contranota	contra	nota
contrapalado	contra	palado
contraparte	contra	parte
contrapartida	contra	partida
contrapozo	contra	pozo
contrapunta	contra	punta
contratiempo	contra	tiempo	تِيَامْبُّ
contribuyente	contribuir	nte
convenientemente	conveniente	mente
conyugicidio	cónyuge	-cidio
coordinadamente	coordinado	mente
copatrono	con	patrono
copiosamente	copioso	mente
coprofagia	-fagia	κόπρος
coprofilia	-filia	κόπρος
coprológico	coprología	-́ico
coprófago	-́fago	κόπρος
coreográfico	-́ico	coreografía
corpudo	cuerpo	-udo
correctamente	correcto	mente
correlato	relatus	con-
correspondientemente	correspondiente	mente
corroborante	corroborar	nte
corrompible	corromper	ble
coruscante	coruscar	nte
cosmográfico	-́ico	cosmografía
cosmogónico	-́ico	cosmogonía
cosmológico	cosmología	-́ico
cosmorama	ὅραμα	cosmo-
cotidianamente	cotidiano	mente
coturnicultura	coturnix	cultura
coxalgia	coxa	algia
craneología	-logía	κρανίον
cremoso	crema	oso
criminología	-logía	crimen
criminológico	criminología	-́ico
criobiología	crio	biología
criogenia	crio	genia
criogenizar	criogenia	izar
crioterapia	crio	terapia
criptoanálisis	cripto	análisis
criptografía	cripto	grafía
criptográfico	criptografía	-́ico
criptología	cripto	logía
criptológico	criptología	-́ico
criptógamo	-́gamo	cripto-
cristalográfico	-́ico	cristalografía
cristología	-logía	Χριστός
critiquizar	crítica	-izar
cromolitografía	cromo	litografía
cromosfera	cromo	esfera
cromógeno	cromo-	-́geno
cronobiología	crono	biología
cronográfico	cronografía	-́ico
cronológicamente	cronológico	mente
cronológico	cronología	-́ico
cronómetro	crono-	-́metro
cruciforme	crux	forme
cuasicontrato	cuasi	contrato
cuatricromía	χρῶμα	-ía	cuatri-
cubrebocas	cubrir	boca
culpablemente	culpable	mente
cuneiforme	cuneus	forme
cunicultura	-cultura	cuniculus
curiosamente	curioso	mente
curvímetro	curvus	-́metro
cálcico	-́ico	calcio
cómodamente	cómodo	mente
dactilografía	dactilo	grafía
dactilográfico	dactilografía	-́ico
dactilológico	dactilología	-́ico
dactiloscópico	dactiloscopia	-́ico
dasonómico	-́ico	dasonomía
decaamperio	deca	amperio
decacandela	deca	candela
decalitro	deca	litro
decatleta	deca	atleta
decavatio	deca	vatio
decentemente	decente	mente
deciamperio	deci	amperio
decicandela	deci	candela
decididamente	decidido	mente
decilitro	deci	litro
decimoctavo	octavo	décimo
decimocuarto	cuarto	décimo
decimonono	décimo	nono
decimonoveno	noveno	décimo
decimoquinto	décimo	quinto
decimosexto	sexto	décimo
decimoséptimo	décimo	séptimo
decimotercio	décimo	tercio
decivatio	deci	vatio
declinómetro	declino	-́metro
decápodo	deca-	-́podo
deficientemente	deficiente	mente
definitivamente	definitivo	mente
deflagrante	deflagrar	nte
degollante	degollar	nte
deicidio	deus	cidio
del	de	el
delegatario	delegar	atario
deliberadamente	deliberado	mente
demográficamente	demográfico	mente
demográfico	demografía	-́ico
demonizar	demonio	izar
demonológico	demonología	-́ico
denostable	denostar	ble
densamente	denso	mente
densímetro	denso	-́metro
deprimente	deprimir	nte
dermalgia	dermo	algia
dermatoesqueleto	dermato	esqueleto
dermatología	dermato	logía
dermatológico	dermatología	-́ico
dermofarmacia	dermo	farmacia
dermofarmacéutico	dermo	farmacéutico
dermoprotección	dermo	protección
dermoprotector	dermo	protector
derrocadero	derrocar	dero
desacertadamente	desacertado	mente
desacreditar	des	acreditar
desaforar	des	aforar
desagradablemente	desagradable	mente
desalinizar	de	salinizar
desalmar	des	alma
desamable	des	amable
desamasado	des	amasado
desamigar	des	amigar
desanimar	des	animar
desapacible	des	apacible
desaplacible	des	aplacible
desarrollar	des	arrollar
desasimilación	des	asimilación
desatascar	des	atascar
desatraillar	des	atraillar
desautorizar	des	autorizar
desavenencia	des	avenencia
desayunar	اَيُنَرْ	des-	ayunar
desbalagar	bálago	des-
descabellar	des	cabello
descarnadamente	descarnado	mente
descartar	des	carta
descoagular	des	coagular
descomponer	des	componer
descomunalmente	descomunal	mente
desconcertante	desconcertar	nte
desconocer	des	conocer
desconversable	des	conversable
descrédito	des	crédito
descuartizar	des	cuarto
desde	de	ex
desempleo	des	empleo
desencadenante	desencadenar	nte
desenhetrable	desenhetrar	ble
desenhetrar	des	enhetrar
deseoso	deseo	oso
desesperadamente	desesperado	mente
desesperante	desesperar	nte
desesperar	des	esperar
desextinción	des	extinción
desfase	des	fase
desfavorablemente	desfavorable	mente
desideologizar	des	ideologizar
desincrustar	des	incrustar
desindustrializar	des	industrializar
deslinajar	des	linaje
desliñar	des	lino
desmedidamente	desmedido	mente
desmesuradamente	desmesurado	mente
desmonetizar	des	monetizar
desobedecer	des	obedecer
desobligar	des	obligar
desobstruir	des	obstruir
desopilante	desopilar	nte
desopilar	des	opilar
desordenar	des	ordenar
desovar	des	ovum
despectivamente	despectivo	mente
despedir	des	pedir
despenalizar	des	penalizar
despidiente	-nte	despedir
despiertamente	despierto	mente
desplegar	des	plegar
desplumadero	desplumar	dero
despreciar	des	preciar
desprender	des	prender
desprolijo	des	prolijo
desregularización	desregularizar	ción
deste	de	este
desteñir	des	teñir
destinar	des	tino
desuncir	des	uncir
desvastigar	vástiga	des-
detalladamente	detallado	mente
detergente	deterger	nte
determinístico	determinista	-́ico
detonante	detonar	nte
devengar	vindico	de-
dextrógiro	gyrus	dexter
diagonalmente	diagonal	mente
diamagnético	dia	magnético
diametralmente	diametral	mente
diariamente	diario	mente
dibujante	dibujar	nte
dicotómico	dicotomía	-́ico
dietoterapia	dieta	terapia
diferentemente	diferente	mente
difteritis	-itis	διφθέρα
digerible	digerir	ble
dignamente	digno	mente
diligentemente	diligente	mente
diplomáticamente	diplomático	mente
directamente	directo	mente
dirigente	dirigir	nte
dirimente	dirimir	nte
discoteca	disco	teca
disfagia	dis	fagia
disforme	dis	forme
disfónico	disfonía	-́ico
disgustar	dis	gustar
dislipemia	dis	lipemia
disparatadamente	disparatado	mente
divergente	divergir	nte
doblemente	doble	mente
dodecafonismo	dodecafonía	ismo
dodecafónico	dodecafonía	-́ico
dogmatizante	dogmatizar	nte
dogmáticamente	dogmático	mente
donante	donar	nte
dramatúrgico	dramaturgia	-́ico
dulcemente	dulce	mente
durablemente	durable	mente
débilmente	débil	mente
ebullómetro	ebullio	-́metro
ecográfico	-́ico	ecografía
ecológicamente	ecológico	mente
ecosistema	eco	sistema
ectodermo	ecto	dermo
ectoplasma	πλάσμα	ecto-
edafología	-logía	ἔδαφος
edafológico	-́ico	edafología
edafólogo	-́logo	ἔδαφος
eficazmente	eficaz	mente
eficientemente	eficiente	mente
egiptológico	egiptología	-́ico
egolatría	ego	latría
ejecutivamente	ejecutivo	mente
ejemplarmente	ejemplar	mente
electrochoque	electro	choque
electroencefalógrafo	encéfalo	electro-	-́grafo
electrolinera	electricidad	gasolinera
electrometalúrgico	electrometalurgia	-́ico
electroquímico	electro	químico
electroterapia	electro	terapia
electroterápico	electroterapia	-́ico
electrotécnico	electrotecnia	-́ico
electrómetro	electro-	-́metro
elevadamente	elevado	mente
embalar	en	bala
embargamiento	embargar	miento
embargoso	embargo	oso
emblemáticamente	emblemático	mente
embriaguez	embriago	ez
embriogenia	ἔμβρυον	-genia
embriológico	embriología	-́ico
emotivamente	emotivo	mente
empalicar	palique	en-
emplazamiento	emplazar	miento
empleomanía	empleo	manía
empollar	pollo	en-
empolvorizar	en	polvorizar
empíricamente	empírico	mente
encarnizadamente	encarnizado	mente
encarnizar	en	carniza
enciclopedismo	enciclopedia	ismo
enciclopedista	enciclopedia	ista
enciclopédico	enciclopedia	-́ico
encubiertamente	encubierto	mente
encubrir	en	cubrir
encumbradamente	encumbrado	mente
endocardio	endo	cardio
endocrinológico	-́ico	endocrinología
endodermo	endo	dermo
endogamia	endo	gamia
endogénesis	endo	génesis
endoplásmico	endo-	-́ico	plasma
endorreísmo	endo-	-ismo	-rrea
endoscopia	endo	scopia
endoscopio	endo	scopio
endotelioma	endotelio	ma
endovascular	endo	vascular
endógamo	-́gamo	endo-
endógeno	endo-	-́geno
endósmosis	endo	ósmosis
enemigablemente	enemigable	mente
energizante	energizar	nte
energizar	energía	izar
enervante	enervar	nte
enfadosamente	enfadoso	mente
enfermizar	enfermo	izar
engranaje	engranar	aje
enigmáticamente	enigmático	mente
enloquecedoramente	enloquecedor	mente
enloquecer	en	loco	ecer
enloquecidamente	enloquecido	mente
enmarcaje	enmarcar	aje
enojosamente	enojoso	mente
enormemente	enorme	mente
enotécnico	enotecnia	-́ico
enredijo	enredar	ijo
enrocar	en-	rueca	roque
enrodrigonar	en	rodrigón
enroque	enrocar	-e
ensalmo	en	salmo
ensiforme	ensis	forme
enteralgia	entero	algia
enteritis	entero	itis
enterocolitis	entero	colitis
entomofagia	-fagia	ἔντομον
entomófago	-́fago	ἔντομον
entramar	en	trama
entrante	entrar	nte
entrañablemente	entrañable	mente
entrañal	entraña	al
entrañalmente	entrañal	mente
entrepierna	entre	pierna
envidiablemente	envidiable	mente
enyugamiento	enyugar	miento
enzimológico	enzimología	-́ico
enérgico	-́ico	energía
epicicloide	epiciclo	oide
epidemiológico	epidemiología	-́ico
epidémico	epidemia	-́ico
epidérmico	epidermis	-́ico
epigramáticamente	epigramático	mente
epigráfico	epigrafía	-́ico
epistemología	-logía	ἐπιστήμη
equitativamente	equitativo	mente
equivalentemente	equivalente	mente
equívocamente	equívoco	mente
ergometría	-metría	ἔργον
ergonómico	-́ico	ergonomía
ergoterapia	ἔργον	-terapia
ergómetro	ἔργον	-́metro
eriotecnia	-tecnia	ἔριον
erotizante	erotizar	nte
erotizar	ἔρως	-izar
erógeno	ἔρως	-́geno
escabrosamente	escabroso	mente
escalofrío	es	calofrío
escarificar	escara	ficar
escasamente	escaso	mente
escintilador	escintilar	dor
escintilómetro	scintilla	-́metro
esclarecer	claresco	ex-
esclarecidamente	esclarecido	mente
escolásticamente	escolástico	mente
escorbútico	escorbuto	-́ico
escorrentía	es	correntío
escuderilmente	escuderil	mente
escudillo	escudo	illo
escuetamente	escueto	mente
escutiforme	scutum	-forme
escépticamente	escéptico	mente
esencialmente	esencial	mente
esgrimidor	esgrimir	dor
espadista	espada	ista
espantosamente	espantoso	mente
especializar	especial	izar
especialmente	especial	mente
espectrofotometría	espectro	fotometría
espectrómetro	espectro	-́metro
especulativamente	especulativo	mente
específicamente	específico	mente
espeleológico	espeleología	-́ico
esperpentismo	esperpento	ismo
espigón	espiga	ón
espiritualmente	espiritual	mente
espirometría	spiro	metría
espirómetro	spiro	-́metro
esplendidez	espléndido	-ez
esponjoso	esponja	oso
espontáneamente	espontáneo	mente
estadista	estado	ista
estandarizar	-izar	estándar
estanflación	inflación	estancamiento
estatalizar	estatal	izar
estatificación	estatificar	ción
estereofónico	estereofonía	-́ico
estereografía	estereo	grafía
estereográfico	estereografía	-́ico
estereotipo	τύπος	στερεός
estereotomía	estereo	tomía
esterilizar	estéril	-izar
estomacal	stomachus	-al
estomatológico	estomatología	-́ico
estopilla	estopa	illo
estorbosamente	estorboso	mente
estrafalariamente	estrafalario	mente
estragamiento	estragar	miento
estrambóticamente	estrambótico	mente
estratificar	-ficar	stratum
estratigráfico	estratigrafía	-́ico
estratosfera	stratus	sphaera
estratosférico	estratosfera	-́ico
estratégicamente	estratégico	mente
estrechamente	estrecho	mente
estrictamente	estricto	mente
estrogénico	estrógeno	-́ico
estructuralmente	estructural	mente
estructurante	estructurar	nte
estruendoso	estruendo	oso
estrógeno	estro	-́geno
estudiante	estudiar	nte
estufero	estufa	ero
estupendamente	estupendo	mente
etano	-ano	éter
etanol	etano	ol
eternamente	eterno	mente
etnología	etno	logía
etnológico	etnología	-́ico
etológico	-́ico	etología
eufónicamente	eufónico	mente
eufónico	eufonía	-́ico
eufóricamente	eufórico	mente
euroconector	euro	conector
eurocracia	euro	cracia
eurozona	euro	zona
eurócrata	euro-	-́crata
evangélicamente	evangélico	mente
eventualmente	eventual	mente
evidentemente	evidente	mente
evolucionismo	evolución	ismo
exactamente	exacto	mente
exalcalde	ex	alcalde
exalumno	ex	alumno
excapitán	ex	capitán
excesivamente	excesivo	mente
excombatiente	ex	combatiente
excompañero	ex	compañero
exesposo	ex	esposo
exhaustivamente	exhaustivo	mente
exitosamente	exitoso	mente
exjefe	ex	jefe
exmarido	ex	marido
exmiembro	ex	miembro
exministro	ex	ministro
exnovio	ex	novio
exobiología	exo	biología
exobiológico	exobiología	-́ico
exocitosis	exo	cito	sis
exocéntrico	exo	céntrico
exoesqueleto	exo	esqueleto
exoftalmia	exo	oftalmia
exorbitantemente	exorbitante	mente
exorcistado	exorcista	ado
exorcizante	exorcizar	nte
exosférico	exosfera	-́ico
exotérmico	exo	térmico
expareja	ex	pareja
expeditamente	expedito	mente
experimentalmente	experimental	mente
expertamente	experto	mente
explicablemente	explicable	mente
explícitamente	explícito	mente
exponente	exponer	nte
expresamente	expreso	mente
expresidente	ex	presidente
expresivamente	expresivo	mente
exquisitamente	exquisito	mente
extemporáneamente	extemporáneo	mente
extensamente	extenso	mente
extensivamente	extensivo	mente
extrajudicial	extra	judicial
extraoficialmente	extraoficial	mente
extraordinariamente	extraordinario	mente
extrapartidario	extra	partidario
extravagantemente	extravagante	mente
extraversión	extra	versión
extrañamente	extraño	mente
extremadamente	extremado	mente
extremamente	extremo	mente
extrínsecamente	extrínseco	mente
exuberantemente	exuberante	mente
exvicepresidente	ex	vicepresidente
exógamo	exo-	-́gamo
exógeno	exo-	-́geno
exónimo	exo	ónimo
fabricante	fabricar	nte
fabulosamente	fabuloso	mente
fachadismo	fachada	ismo
fachentada	fachento	ada
facilitador	facilitar	dor
factual	factum	al
falsabraga	falso	braga
fantasmagóricamente	fantasmagórico	mente
fantásticamente	fantástico	mente
faringitis	faringe	itis
farmacología	-logía	fármaco
farmacológico	farmacología	-́ico
farmacoterapia	-terapia	fármaco
fastuosamente	fastuoso	mente
fatalmente	fatal	mente
fatigosamente	fatigoso	mente
fatigoso	fatiga	oso
fatídicamente	fatídico	mente
favorablemente	favorable	mente
febrilmente	febril	mente
fehacientemente	fehaciente	mente
felizmente	feliz	mente
femenilmente	femenil	mente
fementidamente	fementido	mente
femtogramo	femto	gramo
fenológico	fenología	-́ico
fenomenológico	fenomenología	-́ico
fenotípico	fenotipo	-́ico
fenólico	fenol	-́ico
ferrobús	بُشْ	ferrocarril	bus
ferrocarril	ferro	carril
ferrocarrilero	ferrocarril	ero
ferrocianuro	ferro	cianuro
ferromagnetismo	ferro	magnetismo
ferropenia	ferro-	πενία
ferroprusiato	ferro	prusiato
ferropénico	-́ico	ferropenia
ferroso	ferro	oso
ferrovanadio	ferro	vanadio
ferrovial	ferrovía	al
festivamente	festivo	mente
feticida	feto	cida
feticidio	feto	cidio
fibromialgia	fibra	mialgia
fibromiálgico	fibromialgia	-́ico
figurante	figurar	nte
figurativamente	figurativo	mente
filialmente	filial	mente
filicidio	filius	cidio
filiforme	filum	forme
filmografía	filme	grafía
filmográfico	filmografía	-́ico
filmoteca	filme	teca
filogenia	φῦλον	-genia
filológico	filología	-́ico
filosófico	filosofía	-́ico
filófago	-́fago	φύλλον
finalmente	final	mente
finamente	fino	mente
financista	finanza	ista
firmemente	firme	mente
fisiatría	fisio	iatría
fisiografía	fisio	grafía
fisiológico	fisiología	-́ico
fisionómico	-́ico	fisionomía
fisiopatología	fisio	patología
fisioterapia	fisio	terapia
fisioterápico	fisioterapia	-́ico
fisonómico	fisonomía	-́ico
fitografía	fito	grafía
fitopatología	fito	patología
fitosanitario	fito	sanitario
fitosociología	fito	sociología
fitoterapia	fito	terapia
fitotómico	-́ico	fitotomía
fitozoosanitario	fito	zoo	sanitario
fitófago	-́fago	fito-
fitógrafo	-́grafo	fito-
flamencología	flamenco	logía
flexiblemente	flexible	mente
flirtear	flirt	ear
floculación	flocular	ción
floculante	flocular	nte
flojamente	flojo	mente
floricultura	flos	cultura
flotante	flotar	nte
fluidamente	fluido	mente
fluorimetría	-metría	flúor
foniatría	fono	iatría
fonología	fono	logía
fonotécnico	fonotecnia	-́ico
fonómetro	fono-	-́metro
formalidad	formal	dad
formalmente	formal	mente
formidablemente	formidable	mente
fortuitamente	fortuito	mente
fosfito	-ito	fósforo
fotografía	foto	grafía
fotograma	foto	grama
fotogénesis	foto	génesis
fotometría	foto	metría
fotométrico	fotometría	-́ico
fotoperiodismo	foto	periodismo
fotoperiodista	foto	periodista
fotosensible	foto	sensible
fotosfera	σφαῖρα	foto-
fotosíntesis	foto	síntesis
fototerapia	foto	terapia
fotovoltaico	foto	voltaico
frailear	fraile	ear
fraudulentamente	fraudulento	mente
frecuentemente	frecuente	mente
frenéticamente	frenético	mente
fresal	fresa	al
fruticultura	fruto	cultura
fuertemente	fuerte	mente
fundamentalmente	fundamental	mente
funestamente	funesto	mente
fungiforme	fungus	forme
fungistático	fungus	stático
fungosidad	fungoso	dad
fusiforme	fusus	forme
fúnebremente	fúnebre	mente
fúngico	fungus	-́ico
galaico-portugués	galaico	portugués
galaicoportugués	galaico	portugués
galanamente	galano	mente
galantemente	galante	mente
gallego-portugués	gallego	portugués
gallegoportugués	gallego	portugués
galvanizado	galvanizar	ado
gametofito	gameto	fito
gasoducto	gas	ductus
gasométrico	gasometría	-́ico
gasterópodo	gastero-	-́podo
gastrectomía	gastro	ectomía
gastroenteritis	gastro	enteritis
gastroesofágico	gastro	esofágico
gastrointestinal	gastro	intestinal
gastronómico	gastronomía	-́ico
gastrovascular	gastro	vascular
gasífero	gas	-́fero
gemoterapia	gemma	terapia
generalista	general	ista
generosamente	generoso	mente
generosísimamente	generoso	-mente
genialmente	genial	mente
genuinamente	genuino	mente
genéricamente	genérico	mente
genérico	género	-́ico
genómico	genoma	-́ico
geocentrismo	geo	centro	ismo
geodinámica	geo	dinámica
geoestrategia	geo	estrategia
geofagia	geo	fagia
geogenia	geo	genia
geognosia	geo-	γνῶσις
geográficamente	geográfico	mente
geogénico	geogenia	-́ico
geogónico	geogonía	-́ico
geoide	geo	oide
geología	geo	logía
geológico	geología	-́ico
geomagnetismo	geo	magnetismo
geomorfología	geo	morfología
geomántico	geomancia	-́ico
geonomía	geo	nomía
geonómico	-́ico	geonomía
geopolíticamente	geopolítico	mente
georama	ὅραμα	geo-
georradar	geo	radar
georreferencia	geo	referencia
georreferenciar	geo	referenciar
geotermia	geo	termia
geotérmico	geotermia	-́ico
geriatría	γῆρας	-iatría
gerontocracia	geronto	cracia
gerontócrata	-́crata	geronto-
geófago	geo-	-́fago
gingival	gingiva	al
girasol	girar	sol
giroscopio	giro	scopio
giroscópico	giroscopio	-́ico
giróstato	-stato	γῦρος
glacialmente	glacial	mente
glicémico	glicemia	-́ico
globoflexia	papiroflexia	globo
glucémico	glucemia	-́ico
gobernante	gobernar	nte
golero	gol	ero
golmajear	golmajo	ear
golpiza	golpe	izo
gonádico	gónada	-́ico
graciosamente	gracioso	mente
gradualmente	gradual	mente
grafoscopio	grafo	scopio
gramaticalmente	gramatical	mente
graminológico	graminología	-́ico
granadal	granada	al
gratamente	grato	mente
gravemente	grave	mente
gravitatorio	gravitar	torio
gregariamente	gregario	mente
groseramente	grosero	mente
grotescamente	grotesco	mente
gruesamente	grueso	mente
gráficamente	gráfico	mente
guerrilla	guerra	illo
gustosamente	gustoso	mente
gustoso	gusto	oso
génico	-́ico	gen
habilidosamente	habilidoso	mente
habitualmente	habitual	mente
hablante	hablar	nte
hablista	habla	ista
haciente	hacer	nte
hagiónimo	-ónimo	ἅγιος
halacabuyas	halar	cabuya
halacuerdas	halar	cuerda
halagüeñamente	halagüeño	mente
haplografía	ἁπλόος	-grafía
haplología	ἁπλόος	-logía
harbullista	harbullar	ista
harinear	harina	ear
hartazgo	hartar	azgo
hebdomadariamente	hebdomadario	mente
hechizante	hechizar	nte
hectogramo	hecto	gramo
hectolitro	hecto	litro
hectopascal	hecto	pascal
hectógrafo	hecto-	-́grafo
hegemónicamente	hegemónico	mente
heliocentrismo	helio	centro	ismo
heliograbado	helio	grabado
heliografía	helio	grafía
heliomotor	helio	motor
helioscopio	helio	scopio
heliotelegrafía	helio	telegrafía
helioterapia	helio	terapia
helipuerto	helicóptero	puerto
heliógrafo	-́grafo	helio-
heliómetro	helio-	-́metro
helióstato	helio	stato
hemangioma	hema	angioma
hematermo	hema	termo
hematopoyesis	hemato-	ποίησις
hematoxilina	hemato	xilo	ina
hemocianina	-ina	κύανος	hemo-
hemocultivo	hemo	cultivo
hemoderivado	hemo	derivado
hemodializador	hemo	dializador
hemodinámica	hemo	dinámico
hemodinámico	hemo	dinámico
hemoglobina	globulina	hemo-
hemolisina	hemo	lisina
hemolisis	hemo	́lisis
hemostasia	στάσις	-ia	hemo-
hemostasis	στάσις	hemo-
hemostático	hemo	stático
hemotórax	hemo	tórax
hendedura	hender	dura
hendidura	hendir	dura
hepatización	hepato	izar	ción
herbicida	herba	cida
herbología	herba	logía
hermanal	hermano	al
hermanastro	hermano	astro
hermanuco	hermano	uco
heteroclamídeo	clámide	-́eo	hetero-
heterosfera	hetero	esfera
heteróptero	-́ptero	hetero-
heterótrofo	-́trofo	hetero-
hibridoma	-ma	híbrido
hidrobiología	hidro	biología
hidrobiológico	hidrobiología	-́ico
hidrocloruro	hidro	cloruro
hidroelectricidad	hidro	electricidad
hidroeléctrico	hidro	eléctrico
hidrogenera	hidrógeno	gasolinera
hidrogeológico	hidrogeología	-́ico
hidrográfico	hidrografía	-́ico
hidromántico	hidromancia	-́ico
hidrométrico	hidrometría	-́ico
hidroscopia	hidro	scopia
hidrosférico	hidrosfera	-́ico
hidrostáticamente	hidrostático	mente
hidroterapia	hidro	terapia
hidrotórax	hidro	tórax
hierogamia	-gamia	ἱερός
higroma	higro	ma
higroscopia	higro	scopia
higroscopio	higro	scopio
higroscópico	higroscopio	-́ico
higrómetro	higro-	-́metro
hinduismo	hindú	ismo
hiperboloide	hipérbola	-oide
hiperbárico	hiper	bárico
hiperbólicamente	hiperbólico	mente
hipercalórico	hiper	calórico
hipercolesterolemia	hiper	colesterolemia
hiperemia	hiper	emia
hiperenlace	hiper	enlace
hiperespacio	hiper	espacio
hiperglucemia	hiper	glucemia
hiperglucémico	hiperglucemia	-́ico
hiperinflación	hiper	inflación
hiperinmune	hiper	inmune
hipermercado	hiper	mercado
hiperoxemia	hiper-	hipoxemia
hipersensible	hiper	sensible
hipertensión	hiper	tensión
hipertermia	hiper	termia
hipertonía	hiper-	τόνος
hipertérmico	hipertermia	-́ico
hipertónico	hiper-	τόνος	-́ico
hipervínculo	hiper	vínculo
hipoactividad	hipo	actividad
hipoactivo	hipo	activo
hipoacusia	hipo-	-ia	ἄκουσις
hipoalergénico	hipo	alergénico
hipoalérgico	hipo	alérgico
hipocalórico	hipo	calórico
hipocicloide	hipo	cicloide
hipodérmico	-́ico	hipodermis
hipofaringe	hipo	faringe
hipofosfito	hipo	fosfito
hipoglucemia	hipo	glucemia
hipoglucémico	hipoglucemia	-́ico
hipogénico	hipo	génico
hiposulfito	hipo	sulfito
hipotensión	hipo	tensión
hipotermia	hipo	termia
hipotonía	hipo-	τόνος
hirsutismo	hirsuto	ismo
hispanohablante	hispano	hablante
hispanófilo	-́filo	hispano
histerectomía	ὑστέρα	-ectomía
histoquímica	histo	químico
histoquímico	histo	químico
historiográfico	historiografía	-́ico
historiológico	historiología	-́ico
históricamente	histórico	mente
hocicudo	hocico	udo
hocicón	hocico	ón
holográfico	holografía	-́ico
homeotermia	homeo	termia
homóptero	-́ptero	homo-
honorablemente	honorable	mente
honoríficamente	honorífico	mente
honrosamente	honroso	mente
hoploteca	ὅπλον	-teca
hormonoterapia	hormona	terapia
horriblemente	horrible	mente
horticultura	hortus	cultura
hospitalario	hospitalis	ario
hostilizar	hostil	izar
huisquilar	huisquil	ar
humedal	húmedo	-al
humildemente	humilde	mente
humoralismo	humoral	ismo
humorísticamente	humorístico	mente
hábilmente	hábil	mente
hídrico	hidro-	-́ico
iconoclastia	iconoclasta	ia
ideológico	ideología	-́ico
idiolecto	dialecto	ἴδιος
idiotipo	ἴδιος	tipo
ilegal	in	legal
ilegiblemente	ilegible	mente
ilustremente	ilustre	mente
ilícitamente	ilícito	mente
imbebible	in	bebible
imborrable	in-	-ble	borrar
imbécilmente	imbécil	mente
impajaritablemente	impajaritable	mente
impasable	in	pasable
impasiblemente	impasible	mente
impecablemente	impecable	mente
imperceptiblemente	imperceptible	mente
imperdonablemente	imperdonable	mente
impermeable	in	permeable
impertinentemente	impertinente	mente
imperturbablemente	imperturbable	mente
implacablemente	implacable	mente
imponderablemente	imponderable	mente
imponente	imponer	nte
impopular	in	popular
importante	importar	nte
imposiblemente	imposible	mente
imprescindible	in	prescindible
imprescriptible	in	prescriptible
impresionante	impresionar	nte
imprestable	in-	-ble	prestar
improbablemente	improbable	mente
improcedencia	in	procedencia
imprudentemente	imprudente	mente
impuntual	in	puntual
impuramente	impuro	mente
imputrescible	in	putrescible
inaccesiblemente	inaccesible	mente
inadvertidamente	inadvertido	mente
inalcanzable	in	alcanzable
inauténtico	in	auténtico
incansablemente	incansable	mente
incatalogable	in	catalogable
incautamente	incauto	mente
incesablemente	incesable	mente
incesantemente	incesante	mente
incitante	incitar	nte
incoherentemente	incoherente	mente
incombusto	in	combusto
incomestible	in	comestible
incompletamente	incompleto	mente
inconscientemente	inconsciente	mente
incontinentemente	incontinente	mente
incontrastablemente	incontrastable	mente
incorrectamente	incorrecto	mente
incorregiblemente	incorregible	mente
incuantificable	in	cuantificable
incómodamente	incómodo	mente
indecentemente	indecente	mente
indeciblemente	indecible	mente
indefectiblemente	indefectible	mente
indeleblemente	indeleble	mente
indemnizar	indemne	izar
independientemente	independiente	mente
indeterminadamente	indeterminado	mente
indiferentemente	indiferente	mente
indigenismo	-ismo	indígena
indisolublemente	indisoluble	mente
indispensablemente	indispensable	mente
indisputablemente	indisputable	mente
indivisiblemente	indivisible	mente
indización	indizar	ción
indubitablemente	indubitable	mente
indudablemente	indudable	mente
industrialmente	industrial	mente
inefablemente	inefable	mente
ineludible	in	eludible
ineludiblemente	ineludible	mente
inequidad	in	equidad
inequívocamente	inequívoco	mente
inequívoco	in	equívoco
inevitablemente	inevitable	mente
inexcusablemente	inexcusable	mente
infebril	in	febril
infiltrar	in	filtrar
inframundo	infra	mundo
ingenuamente	ingenuo	mente
injuriosamente	injurioso	mente
inmaculadamente	inmaculado	mente
inmejorablemente	inmejorable	mente
inmensamente	inmenso	mente
inmunoterapia	inmuno	terapia
innegable	in	negable
innegablemente	innegable	mente
innumerablemente	innumerable	mente
inocentemente	inocente	mente
inolvidable	in	olvidable
insaciablemente	insaciable	mente
insecticida	insecto	cida
inseguramente	inseguro	mente
inseparablemente	inseparable	mente
insignemente	insigne	mente
insignificante	in	significante
instintivamente	instintivo	mente
insufriblemente	insufrible	mente
insurgencia	insurgente	ncia
insurgente	insurgir	nte
insustancialmente	insustancial	mente
intangible	in	tangible
inteligiblemente	inteligible	mente
intensificar	intenso	ficar
intercelular	célula	inter-
intercutáneo	inter	cutáneo
interdigital	inter	digital
intermaxilar	inter	maxilar
intermedista	intermedio	ista
intermuscular	inter	muscular
internacional	inter	nacional
interpretativamente	interpretativo	mente
intrahistoria	intra	historia
intrahistórico	-́ico	intrahistoria
intramuscular	intra	muscular
intrépidamente	intrépido	mente
intrínsecamente	intrínseco	mente
inubicable	in	ubicable
invenciblemente	invencible	mente
inverosímilmente	inverosímil	mente
investigable	investigar	ble
inviolablemente	inviolable	mente
irracionablemente	irracionable	mente
irracionalmente	irracional	mente
irreductiblemente	irreductible	mente
irrefragablemente	irrefragable	mente
irreparablemente	irreparable	mente
irreprensiblemente	irreprensible	mente
irresistiblemente	irresistible	mente
irreverentemente	irreverente	mente
irrevocablemente	irrevocable	mente
irídeo	íride	-́eo
islamista	islam	ista
isoentrópico	iso-	-́ico	entropía
isogénico	iso	génico
isométrico	isometría	-́ico
isóptero	-́ptero	iso-
isótropo	τρόπος	iso-
jumentil	jumento	il
justipreciar	precio	justo
kilogramo	kilo	gramo
kilográmetro	kilogramo	-́metro
kilolitro	kilo	litro
kilométrico	kilómetro	-́ico
kilopondio	kilo	pondus
kilómetro	-́metro	kilo-
kinesioterapia	κίνησις	-terapia
kinesioterápico	kinesioterapia	-́ico
laborterapia	labor	terapia
lacerante	lacerar	nte
lancinante	lancinar	nte
langostino	langosta	ino
languidecer	-ecer	lánguido
largada	largar	ada
largamente	largo	mente
latear	lata	ear
laudablemente	laudable	mente
lechal	leche	لَاجَّا	-al
legítimamente	legítimo	mente
lentamente	lento	mente
letificante	letificar	nte
leucoma	leuco	ma
leucopenia	leuco-	πενία
levante	levar	nte
levemente	leve	mente
levógiro	gyrus	laevus
libremente	libre	mente
linfoma	linfa	ma
linfopenia	linfo-	πενία
lipodistrofia	lipo	distrofia
lipoma	lipo	ma
lipoproteína	lipo	proteína
lisina	-ina	λύσις
literalmente	literal	mente
litisexpensas	litis	expensas
litotómico	litotomía	-́ico
litúrgico	liturgia	-́ico
loablemente	loable	mente
lobectomía	lobo	ectomía
lobotómico	lobotomía	-́ico
lobreguez	-ez	lóbrego
locomovible	locus	movible
locomóvil	locus	móvil
logotipo	λόγος	tipo
lotización	lotizar	ción
loxodromía	λοξός	δρόμος
ludopatía	ludus	patía
lumbalgia	lumbus	algia
lumbálgico	lumbalgia	-́ico
luminotecnia	-tecnia	lumen
luminotécnico	-́ico	luminotecnia
lumínico	lumen	-́ico
lustrosamente	lustroso	mente
lícitamente	lícito	mente
lúdico	ludus	-́ico
lúgubremente	lúgubre	mente
macaneada	macanear	ada
macarrónicamente	macarrónico	mente
macizamente	macizo	mente
macrodatos	macro	dato
macroeconómico	-́ico	macroeconomía
macroestructura	macro	estructura
macrofotografía	macro	fotografía
macromolécula	macro	molécula
macronutriente	macro	nutriente
macrospora	σπορά	macro-
macrosporofila	σπορά	φύλλον	macro-
madreperla	madre	بَّارلَ	perla
magnesiotermia	magnesio	termia
magnetismo	magnes	ismo
magnetizar	magnes	izar
magnetosférico	magnetosfera	-́ico
magnetoterapia	magneto	terapia
magnicidio	magnus	cidio
magnánimamente	magnánimo	mente
magnésico	magnesio	-́ico
maizal	maíz	al
maldadoso	maldad	oso
maleable	-ble	malleus
malherbología	malo	herbología
malparir	mal	parir
malsonante	malsonar	nte
mandoble	mano	doble
manifestante	manifestar	nte
manualmente	manual	mente
manzanal	manzano	al
manzanar	manzano	ar
manzanilla	-illo	مَنْزَنَ	manzana
manzanillo	manzano	illo
maquinizar	-izar	máquina
marchoso	marcha	oso
maricultura	mare	cultura
maridablemente	maridable	mente
mascadijo	mascado	ijo
mascotín	mascota	ín
masificar	masa	ficar
mastodóntico	mastodonte	-́ico
matrimonialmente	matrimonial	mente
mayoritariamente	mayoritario	mente
mazacotudo	mazacote	udo
mecanográfico	mecanografía	-́ico
mecenazgo	mecenas	azgo
mechero	mecha	ero
mediante	mediar	nte
medicastro	-astro	médico
medieval	medievo	al
mediocremente	mediocre	mente
megahercio	mega	hercio
megavatio	mega	vatio
melanoma	μέλας	-ma
melifluamente	melifluo	mente
melodrama	μέλος	δρᾶμα
melodramáticamente	melodramático	mente
melonar	melón	ar
melánico	μέλας	-́ico
menguante	menguar	nte
meningitis	meninge	itis
menorragia	μήν	-rragia
menospreciablemente	menospreciable	mente
menospreciar	menos	preciar
mensualmente	mensual	mente
menudencia	menudo	ncia
mercachifle	mercar	chifle
mercadillo	mercado	illo
mercadotécnico	mercadotecnia	-́ico
merdoso	-oso	mierda
merodear	merode	ear
mesocracia	meso	cracia
mesosférico	mesosfera	-́ico
mesoterapia	meso	terapia
mesotrofia	meso	trofia
mesón	meso	ón
metacarpo	καρπός	meta-
metacentro	meta	centro
metaestable	meta	estable
metafito	meta	fito
metafóricamente	metafórico	mente
metalista	metal	ista
metaliteratura	meta	literatura
metalografía	-grafía	metallum
metaloide	metal	oide
metalurgia	μεταλλουργός	-ia
metamatemática	meta	matemática
metamorfismo	meta	morfo	ismo
metapsíquica	meta	psíquico
metapsíquico	meta	psíquico
metatarso	meta-	ταρσός
metatudo	metate	udo
metatórax	meta	tórax
metazoo	meta	zoo
metodológicamente	metodológico	mente
metodológico	metodología	-́ico
metrológico	metrología	-́ico
metrorragia	-rragia	μήτρα
mezquinamente	mezquino	mente
mialgia	mio	algia
micacita	antracita	mica
micológico	micología	-́ico
microalbuminuria	micro	albuminuria
microalga	micro	alga
microbiología	microbio	logía
microcrédito	micro	crédito
microfilmar	micro	filmar
microfilme	micro	filme
microfotográfico	microfotografía	-́ico
microfónico	micrófono	-́ico
microgramo	micro	gramo
micromachismo	micro	machismo
micromecenazgo	micro	mecenazgo
microorganismo	micro	organismo
microplástico	micro	plástico
microprocesador	micro	procesador
mielina	-ina	μυελός
mielitis	μυελός	-itis
mieloma	-ma	μυελός
milagroso	milagro	oso
milgrana	mille	granum
mililitro	mili	litro
milimétricamente	milimétrico	mente
milimétrico	milímetro	-́ico
milímetro	mili-	-́metro
mineralógico	mineralogía	-́ico
miniserie	mini	serie
ministerialismo	ministerial	ismo
minisúper	mini	súper
miocardio	mio	cardio
mioma	mio	ma
mirasol	mirar	sol
miserablemente	miserable	mente
moldura	molde	ura
molestamente	molesto	mente
moleña	-eño	muela
moleño	-eño	muela
molinillo	molino	illo
monetizar	moneta	izar
monocasco	mono	casco
monocatenario	mono	catenario
monocotiledón	mono-	κοτυληδών
monocotiledóneo	monocotiledón	́eo
monocromático	mono	cromático
monocular	mono	ocular
monocultivo	mono	cultivo
monodosis	mono	dosis
monoico	mono-	οἶκος
monotema	mono	tema
monoterapia	mono	terapia
monoteísmo	mono-	-ismo	θεός
montajista	montaje	ista
montañismo	montaña	ismo
monzónico	monzón	́ico
moraleja	moral	ejo
morfotipo	morfo	tipo
moridera	morir	dero
moridor	morir	dor
moriondo	-iondo	morueco
morondanga	morondo	anga
morrudo	morro	udo
mosqueador	mosquear	dor
mosquear	mosca	ear
muertero	muerto	ero
multicine	multi	cine
multidisciplinario	multi	disciplinario
museográfico	museografía	-́ico
museología	museo	logía
museológico	museología	-́ico
musicoterapia	-terapia	música
mutagénico	-génico	mutación
mutágeno	mutación	-́geno
métricamente	métrico	mente
métrico	metro	-́ico
nacionalizar	nacional	izar
nanotecnología	nano	tecnología
nanotecnológico	nanotecnología	-́ico
nanotubo	nano	tubo
naranjal	naranjo	al
narratológico	-́ico	narratología
nasobuco	bucca	nasus
naturalmente	natural	mente
naturalístico	natural	ístico
navegante	navegar	nte
nebular	nebula	ar
necrofagia	necro	fagia
necrolatría	necro	latría
necrológico	necrología	-́ico
necromántico	necromancia	-́ico
nefrectomía	nefro	ectomía
nefrológico	nefrología	-́ico
negligentemente	negligente	mente
neocatólico	neo	católico
neoconservadurismo	neo	conservadurismo
neonato	neo	nato
neonatológico	neonatología	-́ico
neumología	neumo	logía
neumológico	neumología	-́ico
neural	neuro	al
neuralgia	neuro	algia
neurastenia	neuro	astenia
neuroanatomía	neuro	anatomía
neuroanatómico	-́ico	neuroanatomía
neurobiológico	neurobiología	-́ico
neurodiversidad	neuro	diversidad
neuroembriológico	-́ico	neuroembriología
neuroendocrinología	neuro	endocrinología
neuroesqueleto	neuro	esqueleto
neurofisiología	neuro	fisiología
neurofisiológico	-́ico	neurofisiología
neurología	neuro	logía
neurológico	neurología	-́ico
neuroma	neuro	ma
neuromuscular	neuro	muscular
neurotomía	neuro	tomía
neuróptero	neuro-	-́ptero
nevasca	-sco	nieve
nevazo	nieve	-azo
nevisca	-sco	nieve
nietastro	nieto	astro
ningufonear	telefonear	ningunear
niñez	niño	ez
nomofilaxis	φύλαξις	νόμος
normalizar	normal	izar
nostálgico	nostalgia	-́ico
notablemente	notable	mente
nutriente	nutrir	nte
objetivismo	objetivo	ismo
ocasionalmente	ocasional	mente
oceanográfico	oceanografía	-́ico
oculoplástico	oculoplastia	-́ico
odontológico	odontología	-́ico
odontálgico	-́ico	odontalgia
oficialmente	oficial	mente
oficiosamente	oficioso	mente
ofimática	oficina	informática
ofiolatría	ὄφις	-latría
oleicultura	oleum	cultura
oleoducto	oleum	ductus
oligoelemento	oligo	elemento
oligofrenia	oligo-	φρήν
oligotrofia	oligo	trofia
olivar	olivo	ar
olivicultura	oliva	cultura
oncogén	onco	gen
oncogénesis	onco	génesis
oncología	onco	logía
onomasiológico	onomasiología	-́ico
ontogenia	onto	genia
ontogénico	ontogenia	-́ico
opacamente	opaco	mente
opcional	opción	al
operante	operar	nte
opoterapia	-terapia	ὀπός
opoterápico	opoterapia	-́ico
opuestamente	opuesto	mente
orangután	orang	هوتن	اورڠ	hutan
orbicularmente	orbicular	mente
organogenia	ὄργανον	-genia
organografía	-grafía	ὄργανον
organográfico	organografía	-́ico
organológico	organología	-́ico
orificar	oro	ficar
originalmente	original	mente
oropéndola	aureus	pinnula
orquiectomía	-ectomía	ὄρχις
ortóptero	-́ptero	orto-
ostentosamente	ostentoso	mente
osteológico	osteología	-́ico
osteomielitis	osteo	mielitis
osteopenia	osteo-	πενία
osteoplastia	osteo	plastia
osteopático	osteopatía	-́ico
osteotómico	osteotomía	-́ico
ostricultura	ostra	cultura
otorgamiento	otorgar	miento
otorrinolaringológico	otorrinolaringología	-́ico
ovariectomía	ovario	ectomía
ovicida	ovum	cida
ovillejo	ovillo	ejo
oxiacetilénico	-́ico	oxiacetileno
oxidante	oxidar	nte
oxigenoterapia	-terapia	oxígeno
pacientemente	paciente	mente
palatal	palatum	-al
paleoantropológico	paleoantropología	-́ico
paleobiológico	-́ico	paleobiología
paleohispánico	paleo	hispánico
paleontología	paleo	onto	logía
paleoterio	paleo-	θηρίον
paleotestamentario	paleo	testamentario
palpablemente	palpable	mente
pancromático	pan	cromático
papaína	-ina	papayo
papeleta	papel	ete
papiloma	papila	ma
papiriforme	papiro	forme
papiroflexia	flecto	papyrus	-ia
papirológico	papirología	-́ico
para	a	por
parafilia	para	filia
paraguas	agua	اَغُاَ	parar
paralelamente	paralelo	mente
paralitúrgico	paraliturgia	-́ico
paramagnético	para	magnético
parapsicológico	parapsicología	-́ico
parasitología	-logía	parásito
parcialmente	parcial	mente
parear	par	ear
parenteral	ἔντερον	para-
parlamentariamente	parlamentario	mente
parlante	parlar	nte
partenogénesis	παρθένος	-génesis
partidocracia	partido	cracia
parvífico	-́fico	parvus
parámetro	para-	-́metro
pastoralmente	pastoral	mente
pastorilmente	pastoril	mente
patata	papa	batata
patatal	patata	al
patatar	patata	ar
patentemente	patente	mente
patogenicidad	-dad	patogénico
patogenético	pato	genético
pavonear	pavón	ear
pectosa	-osa	πηκτός
peculiarmente	peculiar	mente
pedagógicamente	pedagógico	mente
pedantescamente	pedantesco	mente
pediatría	παῖς	-iatría
peliagudo	pelo	agudo
peligrosamente	peligroso	mente
peligroso	peligro	oso
penalizar	penal	izar
penetrante	penetrar	nte
pentatleta	penta	atleta
peraleda	pera	al	edo
perceptiblemente	perceptible	mente
perdurablemente	perdurable	mente
perennalmente	perennal	mente
perennemente	perenne	mente
perentoriamente	perentorio	mente
perfeccionismo	perfección	ismo
perfectamente	perfecto	mente
periantio	peri-	ἄνθος
periférico	periferia	-́ico
periodismo	periódico	-ismo
periodístico	periodista	-́ico
periódicamente	periódico	mente
perjudicialmente	perjudicial	mente
permanentemente	permanente	mente
permisivamente	permisivo	mente
perniciosamente	pernicioso	mente
perpetuamente	perpetuo	mente
personalmente	personal	mente
pertinazmente	pertinaz	mente
perversamente	perverso	mente
pescante	pescar	nte
pestilencialmente	pestilencial	mente
petimetre	maitre	maître	petit
petrolífero	petróleo	-́fero
piadosamente	piadoso	mente
picadero	picar	dero
picogordo	pico	gordo
pictográfico	pictografía	-́ico
pimental	pimiento	-al
pimpollo	pino	pollo
pinzamiento	pinzar	miento
piriforme	pirum	forme
pirograbar	piro	grabar
piromanía	piro	manía
pirometría	piro	metría
pirosfera	σφαῖρα	piro-
pirotecnia	piro	tecnia
pirotécnico	pirotecnia	-́ico
piroxena	ξένος	piro-
piscicultor	piscis	cultor
piscicultura	piscis	cultura
piscícola	-́cola	piscis
pitecántropo	πίθηκος	ἄνθρωπος
placenteramente	placentero	mente
platanal	plátano	-al
platanar	plátano	-ar
platónicamente	platónico	mente
plausiblemente	plausible	mente
playero	playa	ero
plenamar	pleno	mar
pleuronecto	νηκτός	πλευρά
pluridisciplinario	pluri	disciplinario
pluviómetro	-́metro	pluvia
plácidamente	plácido	mente
poderosamente	poderoso	mente
podología	podo	logía
podómetro	podo-	-́metro
poliadelfo	ἀδελφός	poli-
policopiar	poli	copiar
poliforme	poli	forme
polifónico	polifonía	-́ico
poliginia	γυνή	poli-	-ia
polinización	polinizar	ción
polinómico	polinomio	-́ico
polipiel	polímero	piel
polisemia	poli-	σῆμα
politicólogo	política	-́logo
polivalente	poli	valente
polluelo	pollo	uelo
pomposamente	pomposo	mente
pontificalmente	pontifical	mente
porcicultura	porcus	cultura
porfiadamente	porfiado	mente
pormenor	por	menor
pormenorizar	pormenor	izar
portentosamente	portentoso	mente
posbélico	pos	bélico
posdiluviano	pos	diluviano
posdorsal	pos	dorsal
posguerra	pos	guerra
posiblemente	posible	mente
posmoderno	pos	moderno
posoperatorio	pos	operatorio
pospandemia	pos	pandemia
pospandémico	pos	pandémico
pospretérito	pos	pretérito
postbélico	bélico
postguerra	guerra
postmenopáusico	menopáusico
postmoderno	moderno
potentemente	potente	mente
potásico	potasio	-́ico
praticultura	pratum	cultura
precampaña	pre	campaña
precedente	preceder	nte
precisamente	preciso	mente
predominantemente	predominante	mente
preelectoral	pre	electoral
preferentemente	preferente	mente
preferiblemente	preferible	mente
prehistoria	pre	historia
preliminarmente	preliminar	mente
premenopáusico	pre	menopáusico
prenatal	pre	natal
prenavideño	pre	navideño
prepandemia	pre	pandemia
prepandémico	pre	pandémico
preponderancia	preponderante	ncia
preponderante	preponderar	nte
prepuberal	pre	puberal
prerromano	pre	romano
prescriptible	-ble	prescribir
presencialmente	presencial	mente
presidente	presidir	nte
prestatario	prestar	atario
presuntivamente	presuntivo	mente
preventivamente	preventivo	mente
principalmente	principal	mente
privilegiadamente	privilegiado	mente
probablemente	probable	mente
proctoscopia	πρωκτός	-scopia
proctoscopio	πρωκτός	-scopio
proeuropeo	pro	europeo
profundamente	profundo	mente
profundizar	profundo	izar
profusamente	profuso	mente
progresivamente	progresivo	mente
prohemorrágico	pro	hemorrágico
promiscuamente	promiscuo	mente
proporcionalmente	proporcional	mente
prorruso	pro	ruso
prosaicamente	prosaico	mente
prostatectomía	próstata	-ectomía
proteiforme	proteo	forme
protervamente	protervo	mente
protoalbéitar	proto	albéitar
protohistoria	proto	historia
protolengua	proto	lengua
protomártir	proto	mártir
protoplaneta	proto	planeta
protoplasma	πλάσμα	proto-
proveniente	provenir	nte
proverbialmente	proverbial	mente
provisionalmente	provisional	mente
prudencialmente	prudencial	mente
prósperamente	próspero	mente
pseudoperíptero	seudo	períptero
psicastenia	ἀσθένεια	ψυχή
psicobiología	psico	biología
psicodinámico	psico	dinámico
psicogénico	psico	génico
psicológico	psicología	-́ico
psicopedagogía	psico	pedagogía
psicoterapia	psico	terapia
psicoterapéutico	psico	terapéutico
psicoterápico	psicoterapia	-́ico
psicotécnico	-́ico	psicotecnia
psicrómetro	ψυχρός	-́metro
psicógeno	psico-	-́geno
psitaciforme	ψιττακός	-forme
pterodáctilo	ptero	dáctilo
pubalgia	pubis	algia
puericultura	puer	cultura
puerilmente	pueril	mente
pulcramente	pulcro	mente
puntillo	punto	illo
punzante	punzar	nte
puñada	puño	ada
puñal	puño	al
públicamente	público	mente
queroseno	κηρός	-eno
quilificar	quilo	ficar
quilométrico	quilómetro	-́ico
quilómetro	-́metro	kilo-
quiropraxis	quiro	praxis
quirógrafo	-́grafo	quiro-
quiróptero	-́ptero	quiro-
rabanillo	-illo	rábano
radioastronómico	radioastronomía	-́ico
radiofónico	radiofonía	-́ico
radiológico	radiología	-́ico
radioscopia	radio	scopia
radiosonda	radio	sonda
radiotecnia	radio	tecnia
radiotelefónico	radiotelefonía	-́ico
radioterapia	radio	terapia
radioterápico	radioterapia	-́ico
radiotécnico	-́ico	radiotecnia
ramificar	ramus	ficar
rasante	rasar	nte
razonablemente	razonable	mente
recargamiento	recargar	miento
recazo	re	cazo
reciamente	recio	mente
recomendablemente	recomendable	mente
rectoscopia	recto	scopia
recíprocamente	recíproco	mente
reduflación	inflación	reducción
regicida	rex	cida
regicidio	rex	cidio
regionalismo	regional	ismo
remontar	re	montar
reprográfico	reprografía	-́ico
repugnantemente	repugnante	mente
reseña	re	seña
respectivamente	respectivo	mente
responsablemente	responsable	mente
restrictivamente	restrictivo	mente
resultante	resultar	nte
retranca	retro	anca
retroalimentación	retro	alimentación
retrocognición	retro	cognición
retrogusto	retro	gusto
retrovender	retro	vender
retrovisor	retro	visor
retumbante	retumbar	nte
retóricamente	retórico	mente
reumatológico	reumatología	-́ico
reverentemente	reverente	mente
revoltijo	revuelto	-ijo
riachuelo	riacho	uelo
rinoplastia	rino	plastia
rinoscopia	rino	scopia
riqueza	rico	eza
rizoide	rizo	oide
rizófago	-́fago	rizo-
rompeolas	romper	ola
ruinmente	ruin	mente
runología	runa	logía
runológico	runología	-́ico
ríspido	re	híspido
rúnico	runa	-́ico
sabiamente	sabio	mente
saleta	sala	ete
salinizar	salino	izar
salmuera	sal	muria
salpicadero	salpicar	dero
salpicar	sal	picar
sandial	sandía	al
sandiar	sandía	ar
saponificar	sapo	ficar
saquear	saco	ear
sedimentológico	sedimentología	-́ico
seguidero	seguir	dero
semanalmente	semanal	mente
semasiología	-logía	σημασία
semiabierto	semi	abierto
semicabrón	semi	cabrón
semicilindro	semi	cilindro
semicilíndrico	semicilindro	-́ico
semicircunferencia	semi	circunferencia
semiconductor	semi	conductor
semicorchea	semi	corchea
semicultismo	semi	cultismo
semidescremado	semi	descremado
semidesnatado	semi	desnatado
semidesértico	semi	desértico
semidifunto	semi	difunto
semidiosa	semi	diosa
semidiós	semi	dios
semiesfera	semi	esfera
semifinal	semi	final
semifusa	semi	fusa
semigarrapatea	semi	garrapatea
semiología	-logía	σημεῖον
semiológico	semiología	-́ico
semirremolque	semi	remolque
sensualmente	sensual	mente
septicemia	σηπτικός	-emia
seriamente	serio	mente
sericicultor	sericum	cultor
sericicultura	sericum	cultura
seroterapia	sero	terapia
serotipo	sero	tipo
servomecanismo	servo	mecanismo
seudorreferéndum	seudo	referéndum
severizar	severo	izar
sexológico	sexología	-́ico
sicoterápico	-́ico
sicotécnico	sicotecnia	-́ico
sifiloma	-ma	sífilis
significante	significar	nte
significativamente	significativo	mente
silenciador	silenciar	dor
silvicultura	silva	cultura
silábico	sílaba	-́ico
simpatizante	simpatizar	nte
simplificar	simplex	ficar
simultáneamente	simultáneo	mente
sinfónico	sinfonía	-́ico
sintácticamente	sintáctico	mente
sinérgico	sinergia	-́ico
sismológico	sismología	-́ico
sistemáticamente	sistemático	mente
sobrecoste	sobre	coste
sobrecosto	sobre	costo
sobresaliente	sobresalir	nte
sobreventa	sobre	venta
sociobiología	socio	biología
sociobiológico	-́ico	sociobiología
sociolingüística	socio	lingüística
sociolingüístico	socio	lingüístico
solfista	solfa	ista
solidificar	solidus	ficar
sollozante	sollozar	nte
sonsacar	son	sacar
sorguicultor	sorgo	cultor
sotrozo	so	trozo
soviético	sóviet	-́ico
suavemente	suave	mente
suavizante	suavizar	nte
subcategoría	sub	categoría
subdisciplina	sub	disciplina
sublimemente	sublime	mente
submarino	sub	marino
submaxilar	sub	maxilar
subsiguiente	-nte	subseguir
sucesivamente	sucesivo	mente
sudorífico	-́fico	sudor
sudoríparo	-́paro	sudor
sueroterapia	suero	terapia
suficientemente	suficiente	mente
sulfito	sulphur	-ito
superalimento	super	alimento
superego	super	ego
superhéroe	super	héroe
superiormente	superior	mente
superpotencia	super	potencia
supervillano	super	villano
superyó	super	yo
suplente	suplir	nte
supraciliar	supra	ciliar
suprarrealismo	supra	realismo
suprarrenal	supra	renal
suprasegmental	supra	segmental
supuestamente	supuesto	mente
sursuncorda	sursum	corda
sísmicamente	sísmico	mente
sódico	-́ico	sodio
súbitamente	súbito	mente
tafonómico	tafonomía	-́ico
tajamar	tajar	mar
talasemia	θάλασσα	-emia
talasoterapia	-terapia	θάλασσα
talentoso	talento	oso
tamizaje	tamizar	aje
tanatofobia	tanato	fobia
taumatúrgico	-́ico	taumaturgia
tautológico	tautología	-́ico
taxativamente	taxativo	mente
taxidermia	-dermia	τάξις
taxonómico	taxonomía	-́ico
tecnociencia	tecno	ciencia
tecnocientífico	tecno	científico
tecnofilia	tecno	filia
tecnológico	tecnología	-́ico
tecnófilo	tecno-	-́filo
teleadicto	tele	adicto
teledirigido	tele	dirigir
telefonazo	teléfono	-azo
telefónicamente	telefónico	mente
telegráficamente	telegráfico	mente
telemercadotecnia	tele	mercadotecnia
telespectador	tele	espectador
televidente	tele	vidente
telurismo	tellus	-ismo
telúrico	tellus	-́ico
tempestivamente	tempestivo	mente
temporalmente	temporal	mente
teobroma	βρῶμα	θεός
teogónico	teogonía	-́ico
teológicamente	teológico	mente
teológico	teología	-́ico
teorizante	teorizar	nte
terminológico	terminología	-́ico
termocéfalo	termo	céfalo
termodinámico	termo	dinámico
termoelectricidad	termo	electricidad
termoestable	termo	estable
termografía	termo	grafía
termograma	termo	grama
termogravimetría	termo	gravimetría
termoiónico	termo	iónico
termología	termo	logía
termolábil	termo	lábil
termonuclear	termo	nuclear
termopar	termo	par
termoplástico	termo	plástico
termoscopio	termo	scopio
termosolar	termo	solar
termoterapia	termo	terapia
termógrafo	termo-	-́grafo
termómetro	termo-	-́metro
territorialmente	territorial	mente
tibiamente	tibio	mente
tifoideo	tifo	oide
timol	-ol	thymum
tingible	tingo	ble
tipológico	tipología	-́ico
tomatal	tomate	al
tonificante	tonificar	nte
topología	-logía	τόπος
toponímico	toponimia	-́ico
torpemente	torpe	mente
tortilla	torta	illo
toscamente	tosco	mente
totalmente	total	mente
toxicológico	toxicología	-́ico
tradicionalismo	tradicional	ismo
tradicionalmente	tradicional	mente
tranquilamente	tranquilo	mente
tranquilizante	tranquilizar	nte
transgénero	trans	género
transvasar	trans	vaso
transversalmente	transversal	mente
trashumar	tras	humus
trasluciente	traslucir	nte
trasminar	tras	minar
traspasar	tras	pasar
trastrabillar	tras	traba
trasvasar	tras	vaso
traumatológico	traumatología	-́ico
travesura	-ura	travieso
trazumar	tras	zumo
triatleta	tri	atleta
tribología	tribo	logía
tricentenario	tri	centenario
tricotómico	tricotomía	-́ico
tricromía	χρῶμα	tri-
tridimensional	tri	dimensional
trigal	trigo	al
trikini	tri	bikini
trilocular	tri	loculus	ar
tripulante	tripular	nte
trivialmente	trivial	mente
trofeo	trompudo	feo
trofología	-logía	τροφή
tromboangitis	trombo	angitis
trombocitopenia	trombocito	πενία
trompudo	trompa	udo
troposfera	τρόπος	atmósfera
tusígeno	tussis	-́geno
típicamente	típico	mente
ufológico	ufología	-́ico
ulteriormente	ulterior	mente
ultraactividad	ultra	actividad
ultracongelar	ultra	congelar
ultracorrección	ultra	corrección
ultraderecha	ultra	derecha
ultrafalso	ultra	falso
ultraizquierda	ultra	izquierda
ultrajante	ultrajar	nte
ultraligero	ultra	ligero
ultraliviano	ultra	liviano
ultramar	ultra	mar
ultramarino	ultramar	ino
ultranacionalismo	ultra	nacionalismo
ultrarrico	ultra	rico
ultrasensible	ultra	sensible
ultrasónico	ultra-	-́ico	sonus
undimotriz	unda	motriz
unicelular	uni	celular
unidimensional	uni	dimensional
unidireccional	uni	direccional
unifamiliar	uni	familiar
unificadamente	unificado	mente
unilateral	uni	lateral
urológico	urología	-́ico
usanza	usar	anza
usualmente	usual	mente
uxoricidio	uxor	cidio
vacada	vaca	ada
vacilante	vacilar	nte
vacuna	vaca	uno
vacunoterapia	vacuna	terapia
vampiresa	vampiro	esa
vampirizar	vampiro	izar
vanaglorioso	vanagloria	oso
vaquero	vaca	ero
variablemente	variable	mente
varonilmente	varonil	mente
vasectomía	vaso	ectomía
vecindario	vecindad	ario
vedetismo	vedete	ismo
vehementemente	vehemente	mente
veintésimo	veinte	ésimo
venerablemente	venerable	mente
venereología	-logía	venéreo
verborragia	-rragia	verbo	بَارْبُ
vergazal	vergazo	al
verisímilmente	verisímil	mente
vermicular	vermiculus	ar
vermiforme	vermis	forme
verosímilmente	verosímil	mente
vertebroplastia	vértebra	-plastia
veterotestamentario	testamentario	vetus
vexilología	-logía	vexillum
vexilológico	vexilología	-́ico
viceministro	vice	ministro
victoriosamente	victorioso	mente
videoarbitraje	video	arbitraje
videocasete	video	casete
videoconferencia	video	conferencia
videoconsola	video	consola
videocámara	video	cámara
videofrecuencia	video	frecuencia
videograbar	video	grabar
videojuego	video	juego
vigesimoprimero	primero	vigésimo
vigesimosegundo	vigésimo	segundo
vinicultura	vinum	cultura
vinícola	vinum	-́cola
virología	virus	logía
virológico	virología	-́ico
virtuosamente	virtuoso	mente
viticultura	vitis	cultura
vizconde	viz	conde
volcanología	volcán	-logía
volumetría	volumen	metría
votante	votar	nte
vuecelencia	excelencia	vuestro
vuesarced	vueso	merced
vulcanológico	vulcanología	-́ico
vulgarmente	vulgar	mente
xecudo	xeca	udo
xenofilia	xeno	filia
xenoglosia	γλῶσσα	-ia	xeno-
xenogénico	xeno	génico
xerografía	xero	grafía
xilema	xilo	ma
xilografía	xilo	grafía
xilófago	xilo-	-́fago
xilófono	-́fono	xilo-
yardero	yard	ero
yatrogénico	-génico	ἰατρός
yemoterapia	yema	terapia
zafiamente	zafio	mente
zarzaganillo	zarzagán	illo
zincografía	zinc	grafía
zoantropía	ἄνθρωπος	zoo-
zoofitosanitario	zoo	fito	sanitario
zoolatría	zoo	latría
zoología	zoo	logía
zoológico	zoología	-́ico
zoosanitario	zoo	sanitario
zoospora	σπορά	zoo-
zootecnia	zoo	tecnia
zootécnico	zootecnia	-́ico
zootómico	zootomía	-́ico
zoquetada	zoquete	ada
zoquetero	zoquete	ero
zoquetudo	zoquete	udo
zorrera	zorro	ero
zorrero	zorro	ero
zorrillo	zorro	illo
zorrino	zorro	ino
zoófito	zoo	fito
zoónimo	zoo	ónimo
zoótropo	τρόπος	zoo-
zumiento	zumo	ento
íntegramente	íntegro	mente
ñubloso	ñublo	oso
مِادِيَنْتَا	-nte	mediar
