-artig	Art	ig
-ierung	ier	ung
A-Saite	Saite
Aachener	Aachen	er
Aachenerin	Aachener	in
Aalbeere	Beere	Alant
Aalbestand	Aal	Bestand
Aalfang	Aal	Fang
Aalfett	Aal	Fett
Aalquappe	Aal	Quappe
Aalreuse	Aal	Reuse
Aalsuppe	Aal	Suppe
Aasbande	Aas
Aasblatter	Aas	Blatter
Aasgeier	Aas	Geier
Abart	ab	Art
Abbauprodukt	Abbau	Produkt
Abbiegeassistent	abbiegen	Assistent
Abbildungsfehler	Abbildung	Fehler
Abbildungsmaßstab	Abbildung	Maßstab
Abbildungsverzeichnis	Verzeichniß	Abbildung	Verzeichnis
Abbruchbirne	Abbruch	Birne
Abdampfrückstand	Abdampf	Rückstand
Abdeckerin	Abdecker	in
Abendblatt	Abend	Blatt
Abendbrot	Abend	Brot
Abenddämmerung	Abend	Dämmerung
Abendessen	Abend	Essen
Abendgang	Abend	Gang
Abendgesellschaft	Abend	Gesellschaft
Abendkasse	Abend	Kasse
Abendkleid	Abend	Kleid
Abendkurs	Abend	Kurs
Abendland	Abend	Land
Abendmahl	Abend	Mahl
Abendmahlsgemeinschaft	Abendmahl	Gemeinschaft
Abendmahlslied	Abendmahl	Lied
Abendschule	Abend	Schule
Abendstern	Abend	Stern
Abendveranstaltung	Abend	Veranstaltung
Abendzeitung	Abend	Zeitung
Abenteuererzählung	Abenteuer	Erzählung
Abenteuerliteratur	Abenteuer	Literatur
Abenteuermodus	Abenteuer	Modus
Abenteuerroman	Abenteuer	Roman
Abfallberg	Abfall	Berg
Abfalleimer	Abfall	Eimer
Abfallentsorgung	Abfall	Entsorgung
Abfallholz	Abfall	Holz
Abfalltonne	Abfall	Tonne
Abfallwirtschaft	Abfall	Wirtschaft
Abfertigungsgebühr	Abfertigung	Gebühr
Abflussgebiet	Abfluss	Gebiet
Abfragedienst	Abfrage	Dienst
Abfragesprache	Abfrage	Sprache
Abgabetermin	Abgabe	Termin
Abgasanlage	Abgas	Anlage
Abgasgrenzwert	Abgas	Grenzwert
Abgastemperatur	Abgas	Temperatur
Abgeschmacktheit	abgeschmackt	heit
Abholerin	Abholer	in
Abkühlungsprozess	Abkühlung	Prozess
Abkürzungsverzeichnis	Verzeichniß	Abkürzung	Verzeichnis
Ableitungskanal	Ableitung	Kanal
Ableitungsmorphem	Ableitung	Morphem
Ablenkungsmanöver	Ablenkung	Manöver
Ableserin	Ableser	in
Abnehmerin	Abnehmer	in
Abort	ab	Ort
Absaugung	absaugen	ung
Abschlussdokument	Abschluss	Dokument
Abschlussleiste	Abschluss	Leiste
Abseitsregel	Abseits	Regel
Absenderin	Absender	in
Absichtserklärung	Absicht	Erklärung
Absolutheit	absolut	heit
Absonderungsverordnung	Absonderung	s	Verordnung
Absorptionsspektrum	Absorption	Spektrum
Abstammungsnachweis	Abstammung	Nachweis
Abstandhalter	Abstand	halten	er
Abstraktheit	abstrakt	heit
Abteilungsleiter	Abteilung
Abteilungsleiterin	Abteilungsleiter	in
Abteilungsleitung	Abteilung	Leitung
Abtreibung	abtreiben	ung
Abwasserbehandlung	Abwasser	Behandlung
Abwasserbehandlungsanlage	Abwasserbehandlung	Anlage
Abwasserkanal	Abwasser	Kanal
Abwasserreinigung	Abwasser	Reinigung
Abwasserteich	Abwasser	Teich
Achselhöhle	Achsel	Höhle
Achselschweiß	Achsel	Schweiß
Achswelle	Achse	Welle
Ackerbau	Acker	Bau
Ackerbohne	Acker	Bohne
Ackerdistel	Acker	Distel
Ackererbse	Acker	Erbse
Ackerland	Acker	Land
Acrylharz	Acryl	Harz
Adamsapfel	Adam	s	Apfel
Additionsregel	Addition	Regel
Additionssystem	Addition	System
Additionszeichen	Addition	Zeichen
Adelsprädikat	Adel	Prädikat
Adlerauge	Adler	Auge
Administratorin	Administrator	in
Adverbialsatz	Adverbial	Satz
Adäquatheit	adäquat	heit
Aerosolbildung	Aerosol	Bildung
Aerosolforschung	Aerosol	Forschung
Aerosolkonzentration	Aerosol	Konzentration
Aerosolübertragung	Aerosol	Übertragung
Affekthandlung	Affekt	Handlung
Affenarsch	Affe	Arsch
Affengeschwindigkeit	affen	Geschwindigkeit
Affenhitze	Affe	Hitze
Affentempo	affen	Tempo
Affenzahn	-n	Affe	Zahn	affen-
Afghanin	Afghane	in
Afrikanerin	Afrikaner	in
Afrikanistin	Afrikanist	in
Aggressionskrieg	Aggression	s	Krieg
Agrarwesen	agrar	Wesen
Aha-Erlebnis	aha	Erlebnis
Ahlem-Badenstedt-Davenstedt	Ahlem	Badenstedt	Davenstedt
Ahnenforschung	Ahn	en	Forschung
Ahorntisch	Ahorn	Tisch
Akademikerin	Akademiker	in
Akkordeonistin	Akkordeonist	in
Akkretionsscheibe	Akkretion	Scheibe
Akrobatin	Akrobat	in
Aktiengesellschaft	Aktie	Gesellschaft
Aktionszeitraum	Aktion	s	Zeitraum
Aktivistin	Aktivist	in
Aktivitätsperiode	Aktivität	Periode
Aktivitätsphase	Aktivität	Phase
Aktuarin	Aktuar	in
Akustikerin	Akustiker	in
Albanerin	Albaner	in
Albernheit	albern	heit
Alchemistin	Alchemist	in
Algebraikerin	Algebraiker	in
Algerienkrieg	Algerien	Krieg
Algerierin	Algerier	in
Allergologin	Allergologe	in
Allerwelts-	all	Welt	s
Allerweltsgesicht	Allerwelts	Gesicht
Allerweltskerl	Allerwelts	Kerl
Allerweltsname	Allerwelts	Name
Allerweltspflanze	Allerwelts	Pflanze
Allerweltsproblem	Allerwelts	Problem
Allerweltsreligion	Allerwelts	Religion
Allgemeinverbindlichkeitserklärung	Allgemeinverbindlichkeit	Erklärung
Alltagsradler	Alltag	s	Radler
Altartuch	Altar	Tuch
Altenpflegerin	Altenpfleger	in
Alternativenergie	alternativ	Energie
Altersarmut	Alter	Armut
Altertum	Alter	tum
Altertumswissenschaft	Altertum	Wissenschaft
Altkanzlerin	Altkanzler	in
Amateurfotografin	Amateurfotograf	in
Ameisenbär	Ameise	Bär
Ameisenkolonie	Ameise	Kolonie
Amerikanistin	Amerikanist	in
Aminosäuresequenz	Aminosäure	Sequenz
Ammenmilch	Amme	Milch
Amtsniederlegung	Amt	Niederlegung
Amtssprache	Amt	Sprache
Amtszeit	Amt	Zeit
Analystin	Analyst	in
Ananasfrucht	Ananas	Frucht
Anarchistin	Anarchist	in
Anatomin	Anatom	in
Anbieterin	Anbieter	in
Andorianerin	Andorianer	in
Andorranerin	Andorraner	in
Anfängerglück	Anfänger	Glück
Anführerin	Anführer	in
Anführungszeichen	Anführung	Zeichen
Angeber	angeben	er
Angeberei	angeben	erei
Angelrute	Angel	Rute
Anglistin	Anglist	in
Angolaner	Angola	er
Angolanerin	Angolaner	in
Angriffsgeschwindigkeit	Angriff	s	Geschwindigkeit
Angriffskrieg	Angriff	s	Krieg
Angriffspunkt	Angriff	Punkt
Angsthase	Angst	Hase
Animateurin	Animateur	in
Animationsfilm	Animation	Film
Anisgeschmack	Anis	Geschmack
Anisschnaps	Anis	Schnaps
Annahmestelle	Annahme	Stelle
Annoncenblatt	Annonce	Blatt
Anpassungskosten	Anpassung	s	Kosten
Anpassungsleistung	Anpassung	Leistung
Anpassungsmaßnahme	Anpassung	Maßnahme
Anpassungsmöglichkeit	Anpassung	Möglichkeit
Anpassungsprozess	Anpassung	Prozess
Anredefürwort	Anrede	Fürwort
Anreicherungssystem	Anreicherung	System
Anrufweiterschaltung	Anruf
Ansagerin	Ansager	in
Anschauungsmaterial	Anschauung	Material
Ansprechpartnerin	Ansprechpartner	in
Ansteckungsgefahr	Ansteckung	Gefahr
Antagonistin	Antagonist	in
Anthropologin	Anthropologe	in
Antigravitation	anti	Gravitation
Antimaterie	anti	Materie
Antragsformular	Antrag	Formular
Antriebsachse	Antrieb	Achse
Antriebswelle	Antrieb	Welle
Antwortzeit	Antwort	Zeit
Anwenderin	Anwender	in
Anwendungsmöglichkeit	Anwendung	s	Möglichkeit
Anwendungsprogrammierschnittstelle	Anwendung	Programmierschnittstelle
Anwohnerin	Anwohner	in
Anästhesiologe	Anästhesie	loge
Anästhesiologie	Anästhesie	logie
Anästhesiologin	Anästhesiologe	in
Anästhesistin	Anästhesist	in
Apfelallee	Apfel	Allee
Apfelanbau	Apfel	Anbau
Apfelaroma	Apfel	Aroma
Apfelauflauf	Apfel	Auflauf
Apfelbaum	Apfel	Baum
Apfelbein	Apfel	Bein
Apfelblüte	Apfel	Blüte
Apfelbäckchen	Apfel	Bäckchen
Apfelernte	Apfel	Ernte
Apfelessig	Apfel	Essig
Apfelfrucht	Apfel	Frucht
Apfelkern	Apfel	Kern
Apfelkompott	Apfel	Kompott
Apfelkuchen	Apfel	Kuchen
Apfelmus	Apfel	Mus
Apfelperlwein	Apfel	Perlwein
Apfelpfannkuchen	Apfel	Pfannkuchen
Apfelsaft	Apfel	Saft
Apfelsaftkonzentrat	Apfelsaft	Konzentrat
Apfelsaftschorle	Apfelsaft	Schorle
Apfelschale	Apfel	Schale
Apfelschaumwein	Apfel	Schaumwein
Apfelschorle	Apfel	Schorle
Apfelsekt	Apfel	Sekt
Apfelsinenbaum	Apfelsine	Baum
Apfelsinenschale	Apfelsine	Schale
Apfelsorte	Apfel	Sorte
Apfelstrudel	Apfel	Strudel
Apfelwein	Apfel	Wein
Apfeläther	Apfel	Äther
Apothekerin	Apotheker	in
Appartementwohnung	Wohnung	Apartment
Aprikosenbaum	Aprikose	Baum
Aprikosenblüte	Aprikose
Aprikosenmarmelade	Aprikose	Marmelade
Aprikosensaft	Aprikose	Saft
Apriltag	April	Tag
Aprilwetter	April	Wetter
Arabistin	Arabist	in
Arbeiter	Arbeit
Arbeiterin	Arbeiter	in
Arbeiterklasse	Arbeiter	Klasse
Arbeiterschaft	Arbeiter	schaft
Arbeiterunfallversicherungsgesetz	Arbeiter
Arbeitgeber	Arbeit	Geber
Arbeitgeberin	Arbeitgeber	in
Arbeitnehmer	Arbeit
Arbeitnehmerin	Arbeitnehmer	in
Arbeitsamt	Arbeit	Amt
Arbeitsbereich	Arbeit	Bereich
Arbeitsentgelt	Arbeit	Entgelt
Arbeitsgemeinschaft	Arbeit	Gemeinschaft
Arbeitsgruppe	Arbeit	Gruppe
Arbeitsgruppenleiter	Arbeitsgruppe
Arbeitsgruppenleiterin	Arbeitsgruppenleiter	in
Arbeitsjacke	Arbeit	Jacke
Arbeitskampf	Arbeit	Kampf
Arbeitskraft	Arbeit	Kraft
Arbeitskreis	Arbeit	Kreis
Arbeitslohn	Arbeit	Lohn
Arbeitslosigkeit	arbeitslos	igkeit
Arbeitsmarkt	Arbeit	Markt
Arbeitsmarktchancen	Arbeitsmarkt	Chance
Arbeitsmarktpolitik	Arbeitsmarkt	Politik
Arbeitsmedizin	Arbeit	Medizin
Arbeitsmediziner	Arbeit
Arbeitsmedizinerin	Arbeitsmediziner	in
Arbeitsminister	Arbeit	Minister
Arbeitsniederlegung	Arbeit	s	Niederlegung
Arbeitsorganisation	Arbeit	Organisation
Arbeitsplatte	Arbeit	Platte
Arbeitsplatz	Arbeit	Platz
Arbeitsplatzverlust	Arbeitsplatz	Verlust
Arbeitsproduktivität	Arbeit	Produktivität
Arbeitsrichtlinie	Arbeit	Richtlinie
Arbeitsschuh	Arbeit	Schuh
Arbeitsschutz	Arbeit	Schutz
Arbeitsstunde	Arbeit	Stunde
Arbeitssuche	Arbeit	Suche
Arbeitstag	Arbeit	Tag
Arbeitstisch	Arbeit	Tisch
Arbeitstreffen	Arbeit	Treffen
Arbeitsumsatz	Arbeit	s	Umsatz
Arbeitsunfähigkeitsbescheinigung	Arbeitsunfähigkeit	Bescheinigung
Arbeitsverhältnis	Arbeit	Verhältnis
Arbeitsvisum	Arbeit	Visum
Arbeitsweg	Arbeit	Weg
Arbeitswelt	Arbeit	Welt
Arbeitswilligkeit	Arbeit
Arbeitswissenschaft	Arbeit	Wissenschaft
Arbeitszeit	Arbeit	Zeit
Arbeitszimmer	Arbeit	Zimmer
Arbeitszwang	Arbeit	Zwang
Architektin	Architekt	in
Archivarin	Archivar	in
Archivwissenschaft	Archiv	Wissenschaft
Archäologin	Archäologe	in
Aristokratin	Aristokrat	in
Armband	Arm
Armbanduhr	Armband	Uhr
Armeefahrzeug	Armee	Fahrzeug
Armenierin	Armenier	in
Armkugel	Arm	Kugel
Armseligkeit	armselig	keit
Armutsforschung	Armut	Forschung
Armutsgrenze	Armut	Grenze
Arrangeurin	Arrangeur	in
Arsch-und-Titten-Presse	Arsch	und	Titte	Presse
Arschbombe	Arsch	Bombe
Arschgeweih	Arsch	Geweih
Arschkarte	Arsch	Karte
Arschloch	Arsch	Loch
Arsenkies	Arsen	Kies
Arsenverbindung	Arsen	Verbindung
Arsenvergiftung	Arsen	Vergiftung
Artenvielfalt	Art	Vielfalt
Arterhaltung	Art	Erhaltung
Artischockenherz	Artischocke	Herz
Artistin	Artist	in
Arzneimittel	Arznei	Mittel
Arzneimittelzulassung	Arzneimittel	Zulassung
Arzneimittelzulassungsbehörde	Arzneimittelzulassung	Behörde
Arzneirezept	Arznei	Rezept
Arzthelferin	Arzthelfer	in
Arztsuche	Arzt	Suche
Arzttasche	Arzt	Tasche
Arztwahl	Arzt	Wahl
Asbestuntersatz	Asbest	Untersatz
Aschewolke	Asche	Wolke
Aserbaidschanerin	Aserbaidschaner	in
Asiatin	Asiat	in
Assoziationsfreiheit	Assoziation	Freiheit
Assoziationsmangel	Assoziation
Assoziationsüberschuss	Assoziation	Überschuss
Asteroidengürtel	Asteroid	Gürtel
Astgabel	Ast	Gabel
Astrologin	Astrologe	in
Astronaut	astro	naut
Astronautin	Astronaut	in
Astrophysik	astro	Physik
Astrophysikerin	Astrophysiker	in
Atemschutz	Atem	Schutz
Atemschutzmaske	Atemschutz	Maske
Atemstoß	Atem	Stoß
Atemtechnik	Atem	Technik
Atemvolumen	Atem	Volumen
Atemweg	Atem	Weg
Atemwegsbeschwerde	Atemweg	Beschwerde
Atemwegserkrankung	Atemweg	Erkrankung
Atemzug	Atem	Zug
Atommasse	Atom	Masse
Atommaterial	Atom	Material
Audiologin	Audiologe	in
Aufbaumöbel	Aufbau	Möbel
Aufklärungskampagne	Aufklärung	Kampagne
Aufmerksamkeit	aufmerksam	keit
Aufmerksamkeitsdefizithyperaktivitätsstörung	Aufmerksamkeit	s	Defizit	Hyperaktivität	Störung
Aufmüpfigkeit	aufmüpfig	keit
Aufnahmewagen	Aufnahme	Wagen
Aufsichtsbehörde	Aufsicht	Behörde
Auftragnehmerin	Auftragnehmer	in
Augenarzt	Auge	Arzt
Augenbinde	Auge	Binde
Augenbraue	Auge	n	Braue
Augenlid	Auge	Lid
Augenmaß	Maß
Augenoperation	Auge	Operation
Augenoptikerin	Augenoptiker	in
Augenschatten	Auge	Schatten
Augentäuschung	Auge	Täuschung
Augenwimper	Auge	Wimper
Augusttag	August	Tag
Ausbildungsmaßnahme	Ausbildung	Maßnahme
Ausbildungsmöglichkeit	Ausbildung	Möglichkeit
Ausbildungsprojekt	Ausbildung	Projekt
Ausbreitungsgebiet	Ausbreitung	Gebiet
Ausbreitungsgeschwindigkeit	Ausbreitung	Geschwindigkeit
Ausbreitungsrichtung	Ausbreitung	Richtung
Ausdauersport	Ausdauer	Sport
Ausfallrate	Ausfall	Rate
Ausgabenprogramm	Ausgabe	Programm
Ausgabenverzicht	Ausgabe	Verzicht
Ausgangsniveau	Ausgang	Niveau
Ausgangspunkt	Ausgang	Punkt
Ausgangssperre	Ausgang	s	Sperre
Ausgangsstoff	Ausgang	Stoff
Auskunftspflicht	Auskunft	Pflicht
Auslandszuschlagsverordnung	Auslandszuschlag	Verordnung
Auslassungszeichen	Auslassung	Zeichen
Ausländeranteil	Ausländer	Anteil
Ausländerin	Ausländer	in
Ausmaß	Maß
Ausnahmeverordnung	Ausnahme	Verordnung
Ausnahmezustand	Ausnahme	Zustand
Ausrufezeichen	Ausruf	Zeichen
Austernzucht	Auster	Zucht
Australierin	Australier	in
Auswahlmöglichkeit	Auswahl	Möglichkeit
Ausweispapier	Ausweis	Papier
Auszeichnungsschrift	Auszeichnung	Schrift
Autoabgas	Auto	Abgas
Autobahn	Auto	Bahn
Autobahnbenutzungsgebühr	Autobahn	Benutzungsgebühr
Autobahntunnel	Autobahn	Tunnel
Autobesitzer	Auto	Besitzer
Autobus	Auto	Bus
Autodestruktion	auto	Destruktion
Autofahren	Auto	Fahren
Autofahrer	Auto	Fahrer
Autofahrerin	Auto	Fahrerin
Automobil	auto	mobil
Automobilkonzern	Automobil	Konzern
Autonomiegebiet	Autonomie	Gebiet
Autorin	Autor	in
Autounfall	Auto	Unfall
Autounglück	Auto	Unglück
Autoverkehr	Auto	Verkehr
Autowrack	Auto	Wrack
Außeneinsatz	außen	Einsatz
Außenteam	außen	Team
Babyboom	Baby	Boom
Babyboomer	Babyboom	er
Babyboomerin	Babyboomer	in
Babyklappe	Baby	Klappe
Babysitterin	Babysitter	in
Bachelorstudium	Bachelor	Studium
Backhaus	backen	Haus
Badehaus	baden	Haus
Badekappe	Bad	Kappe
Bademeisterin	Bademeister	in
Bahnbrücke	Bahn	Brücke
Bahngesellschaft	Bahn	Gesellschaft
Bahngleis	Bahn	Gleis
Bahnhof	Bahn	Hof
Bahnhofsbuchhandlung	Bahnhof	Buchhandlung
Bahnhofsgaststätte	Bahnhof	Gaststätte
Bahnhofsgebäude	Bahnhof	Gebäude
Bahnhofsgleis	Bahnhof	Gleis
Bahnhofshalle	Bahnhof	Halle
Bahnstation	Bahn	Station
Bahnsteigkarte	Bahnsteig	Karte
Bahnstrecke	Bahn	Strecke
Bahnübergang	Bahn	Übergang
Bahrainer	Bahrain	er
Bahrainerin	Bahrainer	in
Bakteriologin	Bakteriologe	in
Balkongitter	Balkon	Gitter
Balkonzimmer	Balkon	Zimmer
Ballettmeisterin	Ballettmeister	in
Ballonsatellit	Ballon	Satellit
Balltreter	Ball	Treter
Bananenbaum	Banane	Baum
Bananenbrei	Banane	Brei
Bananenbrot	Banane	Brot
Bananendampfer	Banane	Dampfer
Bananenflanke	Banane	Flanke
Bananenhain	Banane	Hain
Bananenmarkt	Banane	Markt
Bananenpflanzung	Banane	Pflanzung
Bananenrepublik	Banane	Republik
Bananenschale	Banane	Schale
Bananenspinne	Banane	Spinne
Bananenstaude	Banane	Staude
Bananenstecker	Banane	Stecker
Bandnudel	Band	Nudel
Bandoneonistin	Bandoneonist	in
Bandwurm	Band	Wurm
Bandwurmsatz	Bandwurm	Satz
Bangladescherin	Bangladescher	in
Bankhaus	Bank	Haus
Bankierin	Bankier	in
Bankmitarbeiter	Bank	Mitarbeiter
Bankmitarbeiterin	Bankmitarbeiter	in
Banknachbar	Bank	Nachbar
Banknachbarin	Bank	Nachbarin
Banknote	Bank	Note
Banknotenumlauf	Banknote	Umlauf
Bankrecht	Bank	Recht
Bankräuber	Bank	Räuber
Bargeld	bar	Geld
Barockschloss	Schloss
Baronin	Baron	in
Baseballkappe	Baseball	Kappe
Baseballschläger	Baseball	Schläger
Basel-Landschaft	Basel	Landschaft
Bassflöte	Bass	Flöte
Bassistin	Bassist	in
Bauarbeiter	Bau	Arbeiter
Bauchgefühl	Bauch	Gefühl
Bauchgurt	Bauch	Gurt
Bauchkrampf	Bauch	Krampf
Bauchschmerz	Bauch	Schmerz
Bauchspeicheldrüsenentzündung	Bauchspeicheldrüse	Entzündung
Bauchtasche	Bauch	Tasche
Bauchweh	Bauch	Weh
Bauchwelle	Bauch	Welle
Bauerin	Bauer	in
Bauernhaus	Bauer	Haus
Bauingenieur	Bau	Ingenieur
Bauingenieurin	Bauingenieur	in
Baumarktkette	Baumarkt	Kette
Baumdenkmal	Baum	Denkmal
Baumeisterin	Baumeister	in
Baumkuchen	Baum	Kuchen
Baummarder	Baum	Marder
Baumstamm	Baum	Stamm
Baumstumpf	Baum	Stumpf
Baumwolle	Baum	Wolle
Bauplanerin	Bauplaner	in
Baustatikerin	Baustatiker	in
Baustoffindustrie	Baustoff	Industrie
Bauzeichner	Bau	Zeichner
Bayreutherin	Bayreuther	in
Bearbeitungsfrist	Bearbeitung	Frist
Bearbeitungsgeschwindigkeit	Bearbeitung	Geschwindigkeit
Beatmungsdauer	Beatmung	Dauer
Beatmungsgerät	Beatmung	Gerät
Beatmungsmaschine	Beatmung	Maschine
Beatmungsplatz	Beatmung	Platz
Beatmungstherapie	Beatmung	Therapie
Bebauungsplan	Bebauung	Plan
Bedarfsgemeinschaft	Bedarf	Gemeinschaft
Bedeutungserklärung	Bedeutung	Erklärung
Bedienungsanleitung	Bedienung	Anleitung
Bedingtheit	bedingt	heit
Befangenheit	befangen	heit
Befehlshaberin	Befehlshaber	in
Befürworterin	Befürworter	in
Begeisterungsfähigkeit	begeisterungsfähig	keit
Begeisterungssturm	Begeisterung	Sturm
Begeisterungstaumel	Begeisterung	Taumel
Begleiterin	Begleiter	in
Begräbnisstätte	Begräbnis	Stätte
Behandlungsangebot	Behandlung	Angebot
Behandlungskosten	Behandlung	Kosten
Behandlungsmethode	Behandlung	Methode
Beherztheit	beherzt	heit
Beidhänderin	Beidhänder	in
Beinkleid	Bein	Kleid
Beischlaf	bei	Schlaf
Bekanntmachung	bekannt	Machung
Bekenntnisfreiheit	Bekenntnis	Freiheit
Bekämpfungsmittel	Bekämpfung	Mittel
Belarusin	Belaruse	in
Belastungsfähigkeit	belastungsfähig	keit
Beleidigerin	Beleidiger	in
Belgierin	Belgier	in
Beliebtheit	beliebt	heit
Belästigung	belästigen	ung
Benutzerin	Benutzer	in
Benutzername	Benutzer	Name
Benutzung	be	Nutzung
Benutzungsgebühr	Benutzung	Gebühr
Beobachtungsgabe	Beobachtung	Gabe
Beobachtungsstelle	Beobachtung	s	Stelle
Beraterin	Berater	in
Berechnungsmethode	Berechnung	Methode
Bergbahn	Berg	Bahn
Bergkamm	Berg	Kamm
Bergmann	Berg	Mann
Bergsee	Berg	See
Bergsport	Berg	Sport
Bergstation	Berg	Station
Bergsteigerin	Bergsteiger	in
Bergstraße	Straße	Berg	Strasse
Berichterstatterin	Berichterstatter	in
Berliner	Berlin	er
Berufsberaterin	Berufsberater	in
Berufsschülerin	Berufsschüler	in
Berufsunfähigkeitsversicherung	Berufsunfähigkeit	Versicherung
Besatzungskind	Besatzung	Kind
Bescheidenheit	bescheiden	heit
Beschäftigungsförderungsgesetz	Beschäftigungsförderung	Gesetz
Besichtigungszeit	Besichtigung	Zeit
Besitzüberlassung	Besitz	Überlassung
Besitzüberlassungsvertrag	Besitzüberlassung	s	Vertrag
Besserwisserin	Besserwisser	in
Besucherfrequenz	Besucher	Frequenz
Besucherin	Besucher	in
Betagtheit	betagt	heit
Betonpiste	Beton	Piste
Betreuerin	Betreuer	in
Betriebserlaubnis	Betrieb	Erlaubnis
Betriebsfeier	Betrieb	Feier
Betriebssystem	Betrieb	s	System
Betrugssoftware	Betrug	Software
Betrügerin	Betrüger	in
Bettbezug	Bett	Bezug
Bettchen	Bett	chen
Bettdecke	Bett	Decke
Bettlaken	Bett	Laken
Bettlerin	Bettler	in
Bettnachbar	Bett	Nachbar
Bettpfanne	Bett	Pfanne
Beutelmull	Beutel
Bevölkerungsanteil	Bevölkerung	Anteil
Bevölkerungsdichte	Bevölkerung	Dichte
Bevölkerungsgruppe	Bevölkerung	Gruppe
Bevölkerungsschutz	Bevölkerung	Schutz
Bewahranstalt	bewahren	Anstalt
Bewahrerin	Bewahrer	in
Bewirtschaftung	be	Wirtschaft	ung
Bewohnerin	Bewohner	in
Bewunderer	bewundern	er
Bhutaner	Bhutan	er
Bhutanerin	Bhutaner	in
Biathletin	Biathlet	in
Bibliothekarin	Bibliothekar	in
Bibliotheksverzeichnis	Verzeichniß	Bibliothek	Verzeichnis
Bibliothekswissenschaft	Bibliothek	Wissenschaft
Biederkeit	bieder	keit
Bielefelderin	Bielefelder	in
Bienchen	Biene	chen
Bienenhaus	Biene	Haus
Bienenhonig	Biene	Honig
Bienenkorb	Biene	Korb
Bienenkönigin	Biene	Königin
Bienenköniginnenfuttersaft	Königin	Futter	Biene	Saft
Bienenschwarm	Biene
Bienenstich	Biene	Stich
Bienenwachs	Biene	Wachs
Bienenwachskerze	Bienenwachs	Kerze
Bienenzüchter	Biene
Bienenzüchterin	Bienenzüchter	in
Bierabend	Bier	Abend
Bierbauch	Bier	Bauch
Bierchen	Bier	chen
Bierdurst	Bier	Durst
Bierflasche	Bier	Flasche
Biergarten	Bier	Garten
Bierglas	Bier	Glas
Bierkasten	Bier	Kasten
Bierlaune	Bier	Laune
Biestmilch	Biest	Milch
Bilderbuch	Bild	Buch
Bilderbuchautor	Bilderbuch	Autor
Bilderbuchehe	Bilderbuch	Ehe
Bilderbuchfamilie	Bilderbuch	Familie
Bilderbuchkarriere	Bilderbuch	Karriere
Bilderbuchlandschaft	Bilderbuch	Landschaft
Bilderbuchlandung	Bilderbuch	Landung
Bilderbuchschwangerschaft	Bilderbuch	Schwangerschaft
Bilderbuchsommer	Bilderbuch	Sommer
Bilderbuchstart	Bilderbuch	Start
Bilderbuchwetter	Bilderbuch	Wetter
Bilderrahmen	Bild	Rahmen
Bildhauerin	Bildhauer	in
Bildkarte	Bild	Karte
Bildredakteur	Bild	Redakteur
Bildredakteurin	Bildredakteur	in
Bildschirmarbeit	Bildschirm	Arbeit
Bildschirmfoto	Bildschirm	Foto
Bildsprache	Bild	Sprache
Bildstock	Bild	Stock
Bildtafel	Bild	Tafel
Bildtitel	Bild	Titel
Bildungsarbeit	Bildung	Arbeit
Bildungseinrichtung	Bildung	Einrichtung
Bildungsminister	Bildung	Minister
Bildungsministerin	Bildungsminister	in
Bildungsministerium	Bildung	Ministerium
Bildungsroman	Bildung	Roman
Bindewort	Binde	Wort
Bindungsangst	Bindung	Angst
Binnenerzählung	binnen	Erzählung
Biochemikerin	Biochemiker	in
Biologin	Biologe	in
Biologistin	Biologist	in
Biophysik	bio	Physik
Biophysikerin	Biophysiker	in
Biotechnologiefirma	Biotechnologie	Firma
Bisamratte	Ratte
Bittermandelöl	Bittermandel	Öl
Blasinstrument	Blas	Instrument
Blatthäutchen	Blatt	Häutchen
Blattrippe	Blatt	Rippe
Blattsalat	Blatt	Salat
Blaubeere	Blau	Beere
Blauhai	blau	Hai
Blaukehlchen	blau	Kehlchen
Blauäugigkeit	blauäugig	keit
Blechblasinstrument	Blech	Blasinstrument
Blechkuchen	Blech	Kuchen
Blechlawine	Blech	Lawine
Blechtrommel	Blech	Trommel
Bleierz	Blei	Erz
Blinddarmentzündung	Blinddarm	Entzündung
Blindschleiche	Schleiche
Blindwelle	blind	Welle
Blitzlampe	Blitz	Lampe
Bloggerin	Blogger	in
Blumenblatt	Blume	Blatt
Blumenerde	Blume	Erde
Blumenkohl	Blume	Kohl
Blumentopf	Blume	Topf
Blumenwiese	Blume	Wiese
Blutabnahme	Blut	Abnahme
Blutbank	Blut
Blutdruckmessgerät	Blutdruck	Messgerät
Blutentnahme	Blut	Entnahme
Blutersatz	Blut	Ersatz
Blutgefäß	Blut	Gefäß
Bluthochdruck	Blut
Blutkuchen	Blut	Kuchen
Blutmond	Blut	Mond
Blutreinigung	Blut	Reinigung
Bluträcher	Blut	Rächer
Blutsenkungsgeschwindigkeit	Blutsenkung	Geschwindigkeit
Blutspende	Blut	Spende
Bluttest	Blut	Test
Blutuntersuchung	Blut	Untersuchung
Blutwurst	Blut	Wurst
Bläserin	Bläser	in
Blümchen	Blume	chen
Blümchenkaffee	Blümchen	Kaffee
Bodenerosion	Boden	Erosion
Bodenheizung	Boden	Heizung
Bombenerfolg	bomben	Erfolg
Bombenfigur	bomben	Figur
Bombenstimmung	bomben	Stimmung
Bonnerin	Bonner	in
Bootsklasse	Boot	Klasse
Bosniakin	Bosniak	in
Bosnierin	Bosnier	in
Botanikerin	Botaniker	in
Botengang	Bote	Gang
Bothfeld-Vahrenheide	Bothfeld	Vahrenheide
Botschafterin	Botschafter	in
Boulevardjournalismus	Boulevard	Journalismus
Boxerin	Boxer	in
Branntweinessig	Branntwein	Essig
Bratapfel	braten	Apfel
Bratschistin	Bratschist	in
Braunkohlekraftwerk	Braunkohle	Kraftwerk
Bregenzerin	Bregenzer	in
Breitensport	Breite	Sport
Brettchen	Brett	chen
Briefmarke	Brief	Marke
Briefmarkenhändler	Briefmarke	Händler
Brieftaube	Brief	Taube
Briefumschlag	Brief	Umschlag
Brieföffner	Brief	Öffner
Brillenträgerin	Brillenträger	in
Brombeermarmelade	Brombeere	Marmelade
Bronzemedaille	Bronze	Medaille
Bronzezeit	Bronze	Zeit
Brotaufstrich	Brot	Aufstrich
Broterwerb	Brot	Erwerb
Brotherr	Brot	Herr
Brotlaib	Brot	Laib
Browsercache	Browser	Cache
Bruchstelle	Bruch	Stelle
Bruneierin	Bruneier	in
Brustschmerz	Brust	Schmerz
Brustwarze	Brust	Warze
Bruttolohn	brutto	Lohn
Brötchen	Brot	chen
Brötchengeber	Brötchen	Geber
Brötchengeberin	Brötchengeber	in
Brückentag	Brücke	Tag
Brückentunnel	Brücke	Tunnel
Buchautorin	Buchautor	in
Buchbesprechung	Buch	Besprechung
Buchbinderin	Buchbinder	in
Buchdruckerin	Buchdrucker	in
Buchhalterin	Buchhalter	in
Buchhändlerin	Buchhändler	in
Buchkünstler	Buch	Künstler
Buchkünstlerin	Buchkünstler	in
Buchserie	Buch	Serie
Buchstabe	Buch	Stab
Buchstabenform	Buchstabe	Form
Buchstabenschloss	Buchstabe	Schloss
Buchstabensuppe	Buchstabe	n	Suppe
Buchstabentafel	Buchstabe	Tafel
Buchstabentonschrift	Buchstabe	Tonschrift
Buchverkäufer	Buch	Verkäufer
Buchverkäuferin	Buchverkäufer	in
Buchweizen	Buche	Weizen
Buchweizenmehl	Buchweizen	Mehl
Buddhistin	Buddhist	in
Budgetdebatte	Budget	Debatte
Bugfix	bug	fix
Bugreport	Bug	Report
Bundesamt	Bund	Amt
Bundeskanzleramt	Bundeskanzler	Amt
Bundeskanzlerin	Bundeskanzler	in
Bundeslandwirtschaftsministerium	Bund	Landwirtschaftsministerium
Bundesministerin	Bundesminister	in
Bundespräsidentin	Bundespräsident	in
Bundesrepublik	Bund	Republik
Bundestag	Bund	Tag
Bundesverkehrsminister	Bund	Verkehrsminister
Bundesverteidigungsministerium	Bund	Verteidigungsministerium
Bundeswirtschaftsministerium	Bund	Wirtschaftsministerium
Burggraben	Burg	Graben
Buschland	Busch	Land
Buschwerk	Busch	werk
Busenfetischist	Busen	Fetischist
Busfahrerin	Busfahrer	in
Bushaltestelle	Bus	Haltestelle
Busunfall	Bus	Unfall
Butterkuchen	Butter	Kuchen
Butterkäse	Butter	Käse
Buttermesser	Butter	Messer
Buttermilch	Butter	Milch
Bäckergeselle	Bäcker	Geselle
Bäckerin	Bäcker	in
Bärtchen	Bart	chen
Bäuerin	Bauer	in
Bäumchen	Baum	chen
Börsenmaklerin	Börsenmakler	in
Bösewicht	böse	Wicht
Bücherregal	Buch	Regal
Bücherwurm	Buch	Wurm
Bügeleisen	Bügel	Eisen
Bürgergemeinde	Bürger	Gemeinde
Bürgergesellschaft	Bürger	Gesellschaft
Bürgerhaus	Bürger	Haus
Bürgerin	Bürger	in
Bürgerinitiative	Bürger	Initiative
Bürgerkrieg	Bürger	Krieg
Bürgerkriegsland	Bürgerkrieg	s	Land
Bürgermeister	Bürger	Meister
Bürgermeisterin	Bürgermeister	in
Bürgerschule	Bürger	Schule
Bürgerwissenschaft	Bürger	Wissenschaft
Bürogemeinschaft	Büro	Gemeinschaft
Bürohochhaus	Büro	Hochhaus
Büroklammer	Büro	Klammer
Bürolocher	Büro	Locher
Bürostuhl	Büro	Stuhl
CO₂-Abscheidung	CO₂
CO₂-Ausstoß	CO₂
CO₂-Bepreisung	CO₂
CO₂-Bilanz	CO₂	Bilanz
CO₂-Emission	CO₂
CO₂-Fußabdruck	CO₂	Fußabdruck
CO₂-Neutralität	CO₂	Neutralität
CO₂-Preis	CO₂
CO₂-Steuer	CO₂	Steuer
CO₂-Zertifikat	CO₂
CO₂-neutral	CO₂
Campinganzug	Camping	Anzug
Cellistin	Cellist	in
Chefredakteurin	Chefredakteur	in
Chemiefaser	Chemie	Faser
Chemieindustrie	Chemie	Industrie
Chemielabor	Chemie	Labor
Chemielehrer	Chemie	Lehrer
Chemieunfall	Chemie	Unfall
Chemieunterricht	Chemie	Unterricht
Chemikerin	Chemiker	in
Chinesin	Chinese	in
Chirurgin	Chirurg	in
Choreografin	Choreograf	in
Chorleiterin	Chorleiter	in
Christbaum	Christ	Baum
Christbaumkerze	Christbaum	Kerze
Christbaumkugel	Christbaum	Kugel
Christbaumschmuck	Christbaum	Schmuck
Christbescherung	Christ	Bescherung
Chronistin	Chronist	in
Chronograf	chrono	graf
Clownin	Clown	in
Comicliteratur	Comic	Literatur
Coming-of-Age-Film	coming-of-age	Film
Coming-of-Age-Geschichte	coming-of-age	Geschichte
Coming-of-Age-Roman	coming-of-age	Roman
Computeranimation	Computer	Animation
Computerausdruck	Computer	Ausdruck
Computerhersteller	Computer	Hersteller
Computerindustrie	Computer	Industrie
Computerkunst	Computer	Kunst
Computerkurs	Computer	Kurs
Computerlinguistin	Computerlinguist	in
Computermesse	Computer	Messe
Computermodell	Computer	Modell
Computernetz	Computer	Netz
Computernetzwerk	Computer	Netzwerk
Computerpionier	Computer	Pionier
Computersimulation	Computer	Simulation
Computertomographie	Computer	Tomographie
Computerzeitalter	Computer	Zeitalter
Computerzeitschrift	Computer	Zeitschrift
Controllerin	Controller	in
Corona-App	Corona	App
Cosplayer	Cosplay	er
Cosplayerin	Cosplayer	in
Currypulver	Curry	Pulver
Cyber-Strategie	cyber	Strategie
Cyberabwehrzentrum	cyber
Cyberangriff	cyber	Angriff
Cyberattacke	cyber	Attacke
Cybercafé	cyber	Café
Cyberkrieg	cyber	Krieg
Cyberkriminalität	cyber	Kriminalität
Cyberkriminelle	cyber	Kriminelle
Cybermobbing	cyber	Mobbing
Cyberpunk	cyber	Punk
Cybersex	cyber	Sex
Cybersicherheit	cyber	Sicherheit
Cyberstraftäter	cyber	Straftäter
Cyberterror	cyber	Terror
Cyberversicherung	cyber	Versicherung
Cyberwährung	cyber	Währung
D-Saite	Saite
Dachdeckerin	Dachdecker	in
Dachpfanne	Dach	Pfanne
Dachrinne	Dach	Rinne
Dachziegel	Dach	Ziegel
Dackelohr	Dackel	Ohr
Damentoilette	Dame	Toilette
Dampfschiff	Dampf	Schiff
Dampfschifffahrt	Dampfschiff	Fahrt
Dampfschifffahrtsgesellschaft	Dampfschifffahrt	Gesellschaft
Darstellerin	Darsteller	in
Dateiformat	Datei	Format
Datennetz	Daten	Netz
Datenspeicherung	Daten	Speicherung
Dauerwerbesendung	Dauer	Werbesendung
Daumennagel	Daumen	Nagel
Delfinimitator	Delfin	Imitator
Demonstrationsrecht	Demonstration	Recht
Demonstrativadverb	Demonstrativ	Adverb
Dendrochronologie	dendro	Chronologie
Dendroklimatologie	dendro	Klimatologie
Denkelbuch	Denkel	Buch
Denkfehler	denken	Fehler
Denkmalliste	Denkmal	Liste
Denkmalpflegerin	Denkmalpfleger	in
Dermatologin	Dermatologe	in
Designerin	Designer	in
Desinfektionsmittel	Desinfektion	Mittel
Detailhändlerin	Detailhändler	in
Detailregelung	Detail	Regelung
Detektivin	Detektiv	in
Deutschlandticket	Deutschland	Ticket
Deutschlehrerin	Deutschlehrer	in
Deutschsein	Deutsch	sein
Dezembertag	Dezember	Tag
Dezimalsystem	dezimal	System
Diagnosegerät	Diagnose	Gerät
Dialektologin	Dialektologe	in
Diamant-Schwert	Diamant	Schwert
Dichterin	Dichter	in
Dichtermund	Dichter	Mund
Diebin	Dieb	in
Dienerschaft	Diener	schaft
Dienstagabend	Dienstag	Abend
Dienstagmittag	Dienstag	Mittag
Dienstagmorgen	Dienstag	Morgen
Dienstagnachmittag	Dienstag	Nachmittag
Dienstagnacht	Dienstag	Nacht
Dienstagvormittag	Dienstag	Vormittag
Dienstgrad	Dienst	Grad
Dienstleistung	Dienst	Leistung
Dienstschluss	Dienst	Schluss
Dienststelle	Dienst	Stelle
Diffamierungskampagne	Diffamierung	Kampagne
Diktatorin	Diktator	in
Dingwort	Ding	Wort
Direktflug	direkt	Flug
Direktorin	Direktor	in
Dirigentin	Dirigent	in
Dispositionsfreiheit	Disposition	Freiheit
Distanzierungsmaßnahme	Distanzierung	Maßnahme
Doktorin	Doktor	in
Dollarbanane	Dollar	Banane
Dolmetscherin	Dolmetscher	in
Domherrin	Domherr	in
Donau-Auen	Donau	Aue
Donau-Dampfschifffahrtsgesellschaft	Donau	Dampfschifffahrtsgesellschaft
Donauauen	Donau	Aue
Donaudampfschiffahrtsgesellschaftkapitänsmützenständer	Donaudampfschifffahrtsgesellschaftskapitänsmütze	Ständer
Donaudampfschifffahrtsgesellschaft	Donau	Dampfschifffahrtsgesellschaft
Donaudampfschifffahrtsgesellschaftskapitän	Donaudampfschifffahrtsgesellschaft	Kapitän
Donaudampfschifffahrtsgesellschaftskapitänsmütze	Donaudampfschifffahrtsgesellschaftskapitän	Mütze
Donnerstagabend	Donnerstag	Abend
Donnerstagmittag	Donnerstag	Mittag
Donnerstagmorgen	Donnerstag	Morgen
Donnerstagnachmittag	Donnerstag	Nachmittag
Donnerstagnacht	Donnerstag	Nacht
Donnerstagvormittag	Donnerstag	Vormittag
Doppel-T-Eisen	doppel
Doppel-T-Träger	doppel
Doppel-b	doppel
Doppelachse	doppel	Achse
Doppelachter	doppel
Doppeladler	doppel
Doppelagent	doppel	Agent
Doppelagentin	doppel
Doppelaktion	doppel	Aktion
Doppelalbum	doppel	Album
Doppelamt	doppel	Amt
Doppelarbeit	doppel
Doppelaspekt	doppel	Aspekt
Doppelaxt	doppel	Axt
Doppelband	doppel
Doppelbauer	doppel
Doppelbecher	doppel	Becher
Doppelbedeutung	doppel	Bedeutung
Doppelbegabung	doppel	Begabung
Doppelbegriff	doppel	Begriff
Doppelbelastung	doppel	Belastung
Doppelbelichtung	doppel	Belichtung
Doppelbeschluss	doppel	Beschluss
Doppelbesetzung	doppel	Besetzung
Doppelbesteuerung	doppel	Besteuerung
Doppelbett	doppel	Bett
Doppelbewacher	doppel	Bewacher
Doppelbewachung	doppel	Bewachung
Doppelbewegung	doppel	Bewegung
Doppelbier	doppel	Bier
Doppelbild	doppel	Bild
Doppelbindung	doppel	Bindung
Doppelblick	doppel	Blick
Doppelblindstudie	doppel
Doppelblindversuch	doppel
Doppelblock	doppel
Doppelboden	doppel
Doppelbogen	doppel
Doppelbranntwein	doppel	Branntwein
Doppelbrechung	doppel
Doppelbrief	doppel	Brief
Doppelbruch	doppel
Doppelbuchstabe	doppel	Buchstabe
Doppelbödigkeit	doppelbödig	keit
Doppelbüchse	doppel
Doppelbügel	doppel
Doppelcharakter	doppel	Charakter
Doppelchor	doppel	Chor
Doppeldecker	doppel
Doppeldeutung	doppel	Deutung
Doppeldrama	doppel
Doppelehe	doppel	Ehe
Doppeleigenschaft	doppel
Doppelendrohr	doppel
Doppelerfolg	doppel
Doppelerscheinung	doppel
Doppelexistenz	doppel	Existenz
Doppelfehler	doppel	Fehler
Doppelfeld	doppel	Feld
Doppelfenster	doppel	Fenster
Doppelflinte	doppel
Doppelfolge	doppel
Doppelformat	doppel
Doppelfuge	doppel
Doppelfunktion	doppel
Doppelgeburt	doppel
Doppelgesicht	doppel
Doppelgespann	doppel
Doppelgestalt	doppel
Doppelgewebe	doppel
Doppelgipfel	doppel
Doppelgrab	doppel
Doppelgriff	doppel
Doppelgänger	doppel	Gänger
Doppelhaken	doppel	Haken
Doppelhaus	doppel	Haus
Doppelhaushalt	doppel
Doppelhaushaltsplan	doppel
Doppelheft	doppel
Doppelheit	doppel
Doppelhochzeit	doppel
Doppeljahrgang	doppel
Doppelkandidatur	doppel
Doppelkarriere	doppel
Doppelkette	doppel
Doppelkinn	doppel
Doppelkirche	doppel
Doppelklappbett	doppel
Doppelklick	doppel
Doppelknoten	doppel
Doppelkolbenmotor	doppel
Doppelkonsonant	doppel	Konsonant
Doppelkonzert	doppel	Konzert
Doppelkopf	doppel	Kopf
Doppelkorn	doppel
Doppelkreuz	doppel
Doppelkrone	doppel
Doppelkuppel	doppel
Doppelkupplungsgetriebe	doppel
Doppelkurve	doppel	Kurve
Doppelkümmel	doppel
Doppellauf	doppel
Doppellaut	doppel
Doppelleben	doppel
Doppellinie	doppel	Linie
Doppellotterbett	doppel
Doppelmandat	doppel
Doppelmeister	doppel
Doppelmeter	doppel
Doppelmitgliedschaft	doppel
Doppelmonarchie	doppel
Doppelmoral	doppel
Doppelmord	doppel
Doppelmörder	doppel
Doppelnaht	doppel
Doppelname	doppel	Name
Doppelnull	doppel
Doppelnummer	doppel	Nummer
Doppelpack	doppel
Doppelpaddel	doppel	Paddel
Doppelparker	doppel
Doppelpfeil	doppel	Pfeil
Doppelplanet	doppel	Planet
Doppelpony	doppel
Doppelporträt	doppel
Doppelposten	doppel
Doppelpremiere	doppel
Doppelpunkt	doppel
Doppelrahm	doppel
Doppelregierung	doppel
Doppelreihe	doppel	Reihe
Doppelreiher	doppel
Doppelrente	doppel	Rente
Doppelrittberger	doppel
Doppelrolle	doppel
Doppelrumpf	doppel
Doppelrunde	doppel
Doppelsaite	doppel
Doppelsalto	doppel
Doppelsalz	doppel
Doppelschicht	doppel
Doppelschlacht	doppel
Doppelschlag	doppel
Doppelschleife	doppel
Doppelschnitte	doppel
Doppelschritt	doppel
Doppelsechs	doppel
Doppelsehen	doppel
Doppelseite	doppel
Doppelsieg	doppel
Doppelsinn	doppel
Doppelsitzer	doppel
Doppelsohle	doppel
Doppelsonne	doppel
Doppelspalte	doppel
Doppelspiegel	doppel
Doppelspiel	doppel
Doppelspion	doppel
Doppelspionin	doppel
Doppelspitze	doppel
Doppelsprech	doppel
Doppelsprung	doppel
Doppelspüle	doppel
Doppelstaater	doppel
Doppelstaatler	doppel
Doppelstecker	doppel
Doppelstellung	doppel
Doppelstern	doppel	Stern
Doppelstockschub	doppel
Doppelstopper	doppel
Doppelstrang	doppel
Doppelstrategie	doppel
Doppelstreife	doppel
Doppelstruktur	doppel
Doppelstunde	doppel
Doppelstäbchen	doppel
Doppelstück	doppel
Doppelsystem	doppel
Doppelsäule	doppel
Doppeltonne	doppel
Doppeltreffer	doppel
Doppeltriller	doppel
Doppeltür	doppel
Doppelveranlagung	doppel
Doppelverdiener	doppel
Doppelverdienst	doppel
Doppelvergaser	doppel
Doppelverglasung	doppel
Doppelverhältnis	doppel
Doppelvers	doppel
Doppelvierer	doppel
Doppelvokal	doppel
Doppelwahl	doppel	Wahl
Doppelwand	doppel
Doppelweg	doppel
Doppelweiche	doppel
Doppelweltmeister	doppel
Doppelwendel	doppel
Doppelwesen	doppel
Doppelwette	doppel
Doppelwiege	doppel
Doppelwirkung	doppel
Doppelzeile	doppel
Doppelzelle	doppel
Doppelzentner	doppel
Doppelziel	doppel
Doppelzimmer	doppel
Doppelzunge	doppel
Doppelzweier	doppel
Doppelzünder	doppel
Doppelzündung	doppel
Doppelzüngler	doppel
Dorferneuerung	Dorf	Erneuerung
Dorfgemeinde	Dorf	Gemeinde
Dorfgemeinschaft	Dorf	Gemeinschaft
Dorfkirche	Dorf	Kirche
Dorfsowjet	Dorf	Sowjet
Dorfteich	Dorf	Teich
Dorftrottel	Dorf	Trottel
Dorfzentrum	Dorf	Zentrum
Dosenbier	Dose	n	Bier
Dozentin	Dozent	in
Drachentöter	Drache	Töter
Drachentöterin	Drache	Töterin
Drahtbürste	Draht	Bürste
Drahtesel	Draht	Esel
Drahtzieherin	Drahtzieher	in
Dramatikerin	Dramatiker	in
Dramaturgin	Dramaturg	in
Drehbuchautorin	Drehbuchautor	in
Dreikäsehoch	Drei	Käse	hoch
Dreispringerin	Dreispringer	in
Dreizack	Drei	Zacke
Dreizimmerwohnung	drei	Zimmer	Wohnung
Dreizylinder	drei	Zylinder
Dressurreiterin	Dressurreiter	in
Drogendealerin	Drogendealer	in
Druckerin	Drucker	in
Druckindustrie	Druck	Industrie
Druckluft	Druck	Luft
Druckluftspeicherkraftwerk	Druckluft	Speicherkraftwerk
Drummerin	Drummer	in
Dschungelexpedition	Tschungel	Expedition	Dschungel
Dschungelgebiet	Gebiet	Tschungel	Dschungel
Dschungelkampf	Tschungel	Kampf	Dschungel
Dschungelkrieg	Krieg	Tschungel	Dschungel
Dschungelland	Dschungel	Tschungel	Land
Dschungelpfad	Pfad	Tschungel	Dschungel
Dummkopf	dumm	Kopf
Dumpfbacke	dumpf	Backe
Dunsthaube	Dunst	Haube
Durchfallbeschwerde	Durchfall	Beschwerde
Durchführungsstelle	Durchführung	Stelle
Durchschnitt	durch	Schnitt
Durchschnittsalter	Durchschnitt	Alter
Durchschnittsgeschwindigkeit	Durchschnitt	Geschwindigkeit
Durchschnittstemperatur	Durchschnitt	Temperatur
Dystopie	dys-	τόπος
Dänin	Däne	in
Döhren-Wülfel	Döhren	Wülfel
Dörfchen	Dorf	chen
Döslein	Dose	lein
Düngemittelindustrie	Düngemittel	Industrie
Dünnpfiff	dünn	Pfiff
Dürftigkeit	dürftig	keit
Düsseldorferin	Düsseldorf	in
E-Auto	e
E-Bass	e
E-Bassist	e
E-Gitarre	e	Gitarre
E-Mail-Client	E-Mail	Client
E-Mail-Programm	E-Mail	Programm
E-Saite	Saite
EM-Qualifikationsspiel	EM	Qualifikationsspiel
Ebenheit	eben	heit
Echsenmensch	Echse	Mensch
Echtzeitinformation	Echtzeit	Information
Eckpunkt	Ecke	Punkt
Edelkastanie	edel	Kastanie
Edelstein	edel	Stein
Ehehafen	Ehe	Hafen
Ehepaarkurs	Ehepaar	Kurs
Ehepartnerin	Ehepartner	in
Ehezerrüttung	Ehe	Zerrüttung
Ehrendoktorin	Ehrendoktor	in
Ehrentempel	Ehre	Tempel
Eichen	Ei	chen
Eichhase	Eiche	Hase
Eichhorn	Eiche	Horn
Eichhörnchenohr	Eichhörnchen	Ohr
Eichkater	Eiche	Kater
Eichkätzchen	Eichkatze	chen
Eidechse	Echse
Eierbecher	Ei	Becher
Eierfrucht	Ei	Frucht
Eierkuchen	Ei	Kuchen
Eiernudel	Ei	Nudel
Eiersalat	Ei	Salat
Eierschale	Ei	Schale
Eierschalensollbruchstellenverursacher	Eierschale	n	Sollbruchstelle	Verursacher
Eiersoße	Sauce	Sosse	Ei	Soße
Eigenname	eigen	Name
Eigenschaftswort	Eigenschaft	Wort
Einbruchdiebstahlversicherung	Einbruchdiebstahl	Versicherung
Einfamilienhaus	ein	Familie	Haus
Eingangstür	Eingang	Tür
Eingriffsindex	Eingriff	s	Index
Einheitskleidung	Einheit	Kleidung
Einkaufstasche	Einkauf	Tasche
Einkaufstempel	Einkauf	Tempel
Einkaufstüte	Einkauf	Tüte
Einkaufszentrum	Einkauf	Zentrum
Einkommensunterschied	Einkommen	Unterschied
Einkäuferin	Einkäufer	in
Einmarsch	ein	Marsch
Einschlagskrater	Einschlag	Krater
Einseifpinsel	einseifen	Pinsel
Eintrittswahrscheinlichkeit	Eintritt	Wahrscheinlichkeit
Einverständniserklärungsformular	Einverständniserklärung	Formular
Einwohnerin	Einwohner	in
Einzelfallprüfung	Einzelfall	Prüfung
Einzelhändlerin	Einzelhändler	in
Eisaufbruch	Eis	Aufbruch
Eisbecher	Eis	Becher
Eisberg	Eis	Berg
Eisbergsalat	Eisberg	Salat
Eisbär	Eis	Bär
Eisenader	Eisen	Ader
Eisenarbeiter	Eisen	Arbeiter
Eisenbahn	Eisen	Bahn
Eisenbahnanlage	Eisenbahn	Anlage
Eisenbahnbau	Eisenbahn	Bau
Eisenbahninfrastruktur	Eisenbahn	Infrastruktur
Eisenbahnknoten	Eisenbahn	Knoten
Eisenbahnstation	Eisenbahn	Station
Eisenbahntarif	Eisenbahn	Tarif
Eisenbahntunnel	Eisenbahn	Tunnel
Eisenbahnviadukt	Eisenbahn	Viadukt
Eisenbrücke	Eisen	Brücke
Eisenhaken	Eisen	Haken
Eisenmangel	Eisen	Mangel
Eisenmangelanämie	Eisenmangel	Anämie
Eisenoxid	Eisen	Oxid
Eisenstange	Eisen	Stange
Eisgang	Eis	Gang
Eishalle	Eis	Halle
Eishockeyspielerin	Eishockeyspieler	in
Eishöhle	Eis	Höhle
Eisjacht	Eis	Jacht
Eiskaffee	Eis	Kaffee
Eiskappe	Eis	Kappe
Eiskunstläuferin	Eiskunstläufer	in
Eisprung	Ei	Sprung
Eisschale	Eis	Schale
Eissport	Eis	Sport
Eistänzerin	Eistänzer	in
Eiswaffel	Eis	Waffel
Eiswürfel	Eis	Würfel
Eiweiß	Ei	Weiß
Elefantengang	Elefant	Gang
Elefantenohr	Elefant	Ohr
Elektrikerin	Elektriker	in
Elektro-Tretroller	elektro
Elektroakustik	elektro
Elektroanalyse	elektro
Elektroantrieb	elektro
Elektroartikel	elektro
Elektroauto	elektro
Elektrobass	elektro
Elektroberuf	elektro
Elektroboot	elektro
Elektrobranche	elektro
Elektrobus	elektro
Elektrochemie	elektro
Elektrochirurgie	elektro
Elektrocolorverfahren	elektro
Elektrodegen	elektro
Elektrodiagnostik	elektro
Elektrodynamik	elektro
Elektroenergie	elektro
Elektroenzephalografie	elektro
Elektroenzephalograph	elektro
Elektroerosion	elektro
Elektrofahrrad	elektro
Elektrofahrzeug	elektro
Elektrofischerei	elektro
Elektrofotografie	elektro
Elektrogerät	elektro	Gerät
Elektrogeschäft	elektro
Elektrogitarre	elektro	Gitarre
Elektrografie	elektro
Elektrohammer	elektro
Elektrohandwerk	elektro
Elektroheizung	elektro
Elektroherd	elektro
Elektroinduktion	elektro
Elektroindustrie	elektro
Elektroingenieur	elektro
Elektroingenieurin	Elektroingenieur	in
Elektroinstallateur	elektro
Elektroinstallation	elektro
Elektrojet	elektro
Elektrokabel	elektro
Elektrokardiogramm	elektro	Kardiogramm
Elektrokardiograph	elektro
Elektrokardiographie	elektro
Elektrokarren	elektro
Elektrokasten	elektro
Elektrokatalyse	elektro
Elektrokaustik	elektro
Elektrokeramik	elektro
Elektrokocher	elektro
Elektrokonzern	elektro
Elektroleitung	elektro
Elektrolok	elektro
Elektrolokomotive	elektro
Elektrolumineszenz	elektro
Elektrolunge	elektro
Elektrolyse	elektro
Elektrolyt	elektro
Elektromagnet	elektro
Elektromaschine	elektro
Elektromassage	elektro
Elektromechanik	elektro
Elektromechaniker	elektro
Elektromechanikerin	Elektromechaniker	in
Elektromedizin	elektro
Elektromeister	elektro
Elektromelder	elektro
Elektrometall	elektro
Elektrometallurgie	elektro
Elektromobilität	elektro
Elektromonteur	elektro
Elektromotor	elektro
Elektromüll	elektro
Elektronarkose	elektro
Elektronikerin	Elektroniker	in
Elektronikindustrie	Elektronik	Industrie
Elektroofen	elektro
Elektrophon	elektro
Elektrophorese	elektro
Elektrophysiologie	elektro
Elektrorad	elektro
Elektrorasierer	elektro
Elektrorasur	elektro
Elektroroller	elektro
Elektrorollstuhl	elektro
Elektroschiff	elektro
Elektroschock	elektro
Elektroschocker	elektro
Elektroschrott	elektro
Elektroschweißung	elektro
Elektroscooter	elektro
Elektrosensibilität	elektro
Elektroskop	elektro
Elektrosmog	elektro
Elektrosportwagen	elektro	Sportwagen
Elektrostahl	elektro
Elektrostahlguss	elektro
Elektrotechnik	elektro
Elektrotechniker	elektro
Elektrotherapie	elektro
Elektrounfall	elektro
Elektroweidezaun	elektro
Elektrowerker	elektro
Elektrowerkzeug	elektro
Elektrozaun	elektro
Elektrozeit	elektro
Elektrozeitnahme	elektro
Elendsquartier	Elend	Quartier
Elfenbeinküste	Elfenbein	Küste
Elfer	elf	er
Elfmeter	elf	Meter
Elternkurs	Eltern	Kurs
Elternteil	Eltern	Teil
Elternversammlung	Eltern	Versammlung
Emailleurin	Emailleur	in
Emigrantin	Emigrant	in
Emissionsminderungsstrategie	Emissionsminderung	Strategie
Emissionsprüfung	Emission	Prüfung
Emissionsrechtehandel	Emission	s	Recht	Handel
Emissionsstrategie	Emission	Strategie
Emmentalerin	Emmentaler	in
Empfindungswort	Empfindung	Wort
Empfängerin	Empfänger	in
Empfängnisverhütung	Empfängnis	Verhütung
Endgegner	Ende	Gegner
Endlösung	Ende	Lösung
Endokrinologin	Endokrinologe	in
Energieeffizienz	Energie	Effizienz
Energieeinsparung	Energie	Einsparung
Energiehaushalt	Energie	Haushalt
Energiekrise	Energie	Krise
Energieversorger	Energie	Versorger
Energieversorgung	Energie	Versorgung
Energieversorgungsunternehmen	Energieversorgung	Unternehmen
Engländerin	Engländer	in
Enkelin	Enkel	in
Enkelsohn	Enkel	Sohn
Enkeltochter	Enkel	Tochter
Enkeltrick	Enkel	Trick
Entbindung	ent	Bindung
Entbindungspfleger	Entbindung	Pfleger
Entbindungspflegerin	-in	Entbindungspfleger	-s-	Pflegerin	Entbindung
Entdeckerin	Entdecker	in
Entdeckungsort	Entdeckung	Ort
Entfremdung	ent	fremd	ung
Entkleidungsszene	Entkleidung	Szene
Entkriminalisierung	entkriminalisieren	ung
Entlassungspraxis	Entlassung	Praxis
Entnazifizierungskommission	Entnazifizierung	Kommission
Entomologin	Entomologe	in
Entscheidungsproblem	Entscheidung	Problem
Entsorgerin	Entsorger	in
Entstehungsprozess	Entstehung	Prozess
Entwicklerin	Entwickler	in
Entwicklungsbiologie	Entwicklung	Biologie
Entwicklungshilfeministerin	Entwicklungshilfeminister	in
Entwicklungshilfeministerium	Entwicklungshilfe	Ministerium
Entwicklungspolitik	Entwicklung	Politik
Entwicklungsroman	Entwicklung	Roman
Entwicklungsstufe	Entwicklung	Stufe
Entwicklungsverlauf	Entwicklung	Verlauf
Entwicklungsweg	Entwicklung	Weg
Entwurfsgeschwindigkeit	Entwurf	Geschwindigkeit
Entzündungsparameter	Entzündung	Parameter
Entzündungsreaktion	Entzündung	Reaktion
Entzündungszeichen	Entzündung	Zeichen
Epidemiebekämpfung	Epidemie	Bekämpfung
Epidemiegesetz	Epidemie	Gesetz
Epidemiologin	Epidemiologe	in
Erbschaftsauseinandersetzung	Erbschaft	Auseinandersetzung
Erbsenkeim	Erbse	Keim
Erbsenpflanze	Erbse	n	Pflanze
Erbsensamen	Erbse	n	Samen
Erbsenzähler	Erbse	Zähler
Erdapfel	Erde	Apfel
Erdapfelsalat	Erdapfel	Salat
Erdatmosphäre	Erde	Atmosphäre
Erdbeerbaum	Erdbeere	Baum
Erdbeerbowle	Erdbeere	Bowle
Erdbeere	Erde	Beere
Erdbeereis	Erdbeere	Eis
Erdbeergeschmack	Erdbeere	Geschmack
Erdbeerkompott	Erdbeere	Kompott
Erdbeerkuchen	Erdbeere	Kuchen
Erdbeerlikör	Erdbeere	Likör
Erdbeermarmelade	Erdbeere	Marmelade
Erdbeersaft	Erdbeere	Saft
Erdbeersaison	Erdbeere	Saison
Erdbeertorte	Erdbeere	Torte
Erdbeerwein	Erdbeere	Wein
Erdbeschreibung	Erde	Beschreibung
Erdbestattung	Erde	Bestattung
Erdbirne	Erde	Birne
Erdgas	Erde	Gas
Erdgasfahrzeug	Erdgas	Fahrzeug
Erdgaspreis	Erdgas	Preis
Erdgasvorkommen	Erdgas	Vorkommen
Erdkunde	Erde	kunde
Erdling	Erde	ling
Erdmännchen	Erde	Männchen
Erdnuss	Erde	Nuss
Erdnussbutter	Erdnuss	Butter
Erdnussöl	Erdnuss	Öl
Erdteil	Erde	Teil
Erdäquator	Erde	Äquator
Ereignishorizont	Ereignis	Horizont
Erfahrungspunkt	Erfahrung	s	Punkt
Erfahrungswissenschaft	Erfahrung	Wissenschaft
Erfinderin	Erfinder	in
Erfolgsaussicht	Erfolg	Aussicht
Erfolgsrezept	Erfolg	Rezept
Ergotherapeutin	Ergotherapeut	in
Erinnerungsverlust	Erinnerung	s	Verlust
Erinnerungsvermögen	Erinnerung	Vermögen
Erkenntnistheorie	Erkenntnis	Theorie
Erklärungsnot	Erklärung	Not
Erklärungsversuch	Erklärung	Versuch
Erkrankungsbeginn	Erkrankung	Beginn
Erkrankungsfall	Erkrankung	Fall
Erkrankungsschwere	Erkrankung	Schwere
Erkrankungssymptom	Erkrankung	Symptom
Erkrankungsursache	Erkrankung	Ursache
Erkrankungsverlauf	Erkrankung	Verlauf
Erkrankungswelle	Erkrankung	Welle
Erkundungsgang	Erkundung	Gang
Ermittlerin	Ermittler	in
Ernährerin	Ernährer	in
Ernährungswissenschaftlerin	Ernährungswissenschaftler	in
Erpresserin	Erpresser	in
Ersatzhaltestelle	Ersatz	Haltestelle
Erstkontakt	erst	Kontakt
Erwerberin	Erwerber	in
Erzeugerin	Erzeuger	in
Erzeugerland	Erzeuger	Land
Erzieherin	Erzieher	in
Erziehungsurlaub	Erziehung	Urlaub
Erziehungswissenschaft	Erziehung	Wissenschaft
Erziehungswissenschaftlerin	Erziehungswissenschaftler	in
Erzählerin	Erzähler	in
Eselsbrücke	Esel	Brücke
Eselsmilch	Esel	Milch
Eselsohr	Esel	Ohr
Esperantistin	Esperantist	in
Esperantologin	Esperantologe	in
Espressomaschine	Espresso	Maschine
Essayistin	Essayist	in
Essiggurke	Essig	Gurke
Esskastanie	Kastanie
Esslust	essen	Lust
Esslöffel	Löffel
Essstäbchen	essen	Stäbchen
Esszimmer	essen	Zimmer
Estin	Este	in
Estländerin	Estländer	in
Et-Zeichen	et	Zeichen
Ethnologin	Ethnologe	in
Etymologin	Etymologe	in
Eukalyptusöl	Eukalyptus	Öl
Europameisterschaft	Europa	Meisterschaft
Exoplanet	exo	Planet
Expertin	Experte	in
Explosionsherd	Explosion	Herd
Exraucherin	Exraucher	in
Extremwert	Extrem	Wert
Extremwetter	Extrem	Wetter
Fachausdruck	Fach	Ausdruck
Fachausschuss	Fach	Ausschuss
Fachwerk	Fach	Werk
Fachwerkhaus	Fachwerk	Haus
Fachzirkel	Fach	Zirkel
Fadendichte	Faden	Dichte
Fagottistin	Fagottist	in
Fahnenmast	Fahne	Mast
Fahrbahnmarkierung	Fahrbahn	Markierung
Fahrgastinformation	Fahrgast	Information
Fahrgastschiff	Fahrgast	Schiff
Fahrgastzahl	Fahrgast	Zahl
Fahrgerät	fahren	Gerät
Fahrrad	fahren	Rad
Fahrradautobahn	Fahrrad	Autobahn
Fahrradfahren	Fahrrad	Fahren
Fahrradfahrer	Fahrrad	Fahrer
Fahrradfahrerin	Fahrradfahrer	in
Fahrradgabel	Fahrrad	Gabel
Fahrradglocke	Fahrrad	Glocke
Fahrradkette	Fahrrad	Kette
Fahrradparkplatz	Fahrrad	Parkplatz
Fahrradsattel	Fahrrad	Sattel
Fahrradstadt	Fahrrad	Stadt
Fahrradunfall	Fahrrad	Unfall
Fahrschein	fahren	Schein
Fahrscheinkontrolle	Fahrschein	Kontrolle
Fahrstuhl	fahren	Stuhl
Fahrstuhlmusik	Fahrstuhl	Musik
Fahrstuhlschacht	Fahrstuhl	Schacht
Falkenauge	Falke	Auge
Fallschirm	Fall	Schirm
Falschaussage	falsch	Aussage
Falschfahrerin	Falschfahrer	in
Falschparkerin	Falschparker	in
Familienbegräbnis	Familie	Begräbnis
Familienforschung	Familie	n	Forschung
Familiengrab	Familie	Grab
Familienname	Familie	Name
Familienstammbaum	Familie	n	Stammbaum
Familientreffen	Familie	Treffen
Fanartikel	Fan	Artikel
Fanggerät	fangen	Gerät
Farbenlehre	Farbe	Lehre
Farbpapier	Farbe	Papier
Farbroller	Farbe	Roller
Faschingssonntag	Fasching	Sonntag
Faserplatte	Faser	Platte
Fassbier	Fass	Bier
Fastnacht	fasten	Nacht
Fastnachtszeit	Fastnacht	Zeit
Faxgerät	Fax	Gerät
Faxnummer	Fax	Nummer
Fechterin	Fechter	in
Federmappe	Feder	Mappe
Federvieh	Feder	Vieh
Fehlbetrag	Betrag
Feierabend	feiern	Abend
Feiertag	Feier	Tag
Feldexperiment	Feld	Experiment
Feldfrucht	Feld	Frucht
Feldherrin	Feldherr	in
Feldmarschall	Feld	Marschall
Feldspat	Feld	Spat
Feldstecher	Feld	Stecher
Feldwebel	Weibel	Feld
Feministin	Feminist	in
Fensterrahmen	Fenster	Rahmen
Fensterzarge	Fenster	Zarge
Ferientag	Ferien	Tag
Fernfahrerin	Fernfahrer	in
Fernglas	fern	Glas
Fernsehmoderatorin	Fernsehmoderator	in
Fernsehproduzentin	Fernsehproduzent	in
Fernsprecher	fern	sprechen	er
Festtag	Fest	Tag
Festungsgraben	Festung	Graben
Fettbemme	Fett	Bemme
Fettgriebe	Fett	Griebe
Feuerbaum	Feuer	Baum
Feuerholz	Feuer	Holz
Feuerlöscher	Feuer	Löscher
Feuerlöschteich	Feuer	löschen	Teich
Feuerversicherungsgesellschaft	Feuerversicherung	Gesellschaft
Feuerwehrfrau	Feuerwehr	Frau
Feuerwehrmann	Feuerwehr	Mann
Feuerwehrwache	Feuerwehr	Wache
Feuerzeug	Feuer	Zeug
Filialleiterin	Filialleiter	in
Filmemacherin	Filmemacher	in
Filmkamera	Film	Kamera
Filmkomponist	Film	Komponist
Filmkomponistin	Filmkomponist	in
Filmkritikerin	Filmkritiker	in
Filmproduzent	Film	Produzent
Filmproduzentin	Filmproduzent	in
Filmregisseur	Film	Regisseur
Filmregisseurin	Filmregisseur	in
Filmrezension	Film	Rezension
Filmschauspielerin	Filmschauspieler	in
Filmzeitschrift	Film	Zeitschrift
Filterkuchen	Filter	Kuchen
Finanzbehörde	Finanz	Behörde
Finanzberater	Finanz	Berater
Finanzberaterin	Finanzberater	in
Finanzvorstand	Finanz	Vorstand
Fingerabdruck	Finger	Abdruck
Fingerhut	Finger	Hut
Fingerkuppe	Finger	Kuppe
Fingernagel	Finger	Nagel
Fingerring	Finger	Ring
Fingerschale	Finger	Schale
Fingerspitze	Finger	Spitze
Fingerspitzengefühl	Fingerspitze	Gefühl
Finnin	Finne	in
Finnländerin	Finnländer	in
Fischereigrenze	Fischerei	Grenze
Fischereiwissenschaft	Fischerei	Wissenschaft
Fischerin	Fischer	in
Fischmesser	Fisch	Messer
Fischrestaurant	Fisch	Restaurant
Fischrogen	Fisch	Rogen
Fischschwanz	Fisch	Schwanz
Fischstäbchen	Fisch	Stäbchen
Fischzug	Fisch	Zug
Fischöl	Fisch	Öl
Fistbump	fist	bump
Fitnessgerät	Fitness	Gerät
Flammenkuchen	Flamme	Kuchen
Flaschenbier	Flasche	Bier
Flaschenhals	Flasche	Hals
Flaschenhalter	Flasche	Halter
Flaschenpfand	Flasche	Pfand
Flaschenöffner	Flasche	Öffner
Fleischerin	Fleischer	in
Fleischersatz	Fleisch	Ersatz
Fleischindustrie	Fleisch	Industrie
Fleischkonsum	Fleisch	Konsum
Fliegenklatsche	Fliege	Klatsche
Fliegerkorps	Flieger	Korps
Fliesenlegerin	Fliesenleger	in
Fließband	Band
Fließbandarbeit	Fließband	Arbeit
Fließgewässer	Fliess	Gewässer	Fließ
Flitzbogen	flitzen	Bogen
Flohmarkt	Floh	Markt
Floriansjünger	Florian	s	Jünger
Floriansjüngerin	Floriansjünger	in
Floristin	Florist	in
Flugdrache	Flug	Drache
Fluggast	Flug	Gast
Fluggastvorratsdatenspeicherung	Fluggast	Vorratsdatenspeicherung
Flughafengelände	Flughafen	Gelände
Fluidtechnik	Fluid	Technik
Flusspferd	Fluss	Pferd
Flötenspielerin	Flötenspieler	in
Flötistin	Flötist	in
Flüchtling	flüchten	ling
Flüsschen	Fluss	chen
Flüssigkeit	flüssig	keit
Forscherin	Forscher	in
Forschungsdaten	Forschung	s	Daten
Forschungsdateninfrastruktur	Forschungsdaten	Infrastruktur
Forschungseinrichtung	Forschung	Einrichtung
Forschungsfreiheit	Forschung	Freiheit
Forschungslabor	Forschung	Labor
Forschungspartner	Forschung	s	Partner
Forschungsprojekt	Forschung	Projekt
Fortpflanzungsgeschwindigkeit	Fortpflanzung	Geschwindigkeit
Fotografie	foto	grafie
Fotografin	Fotograf	in
Fotoindustrie	Foto	Industrie
Fotojournalistin	Fotojournalist	in
Fotolabor	Foto	Labor
Fotovoltaik	foto	Volt
Frachtraum	Fracht	Raum
Fragesatz	Frage	Satz
Fragestellung	Frage	Stellung
Fragewort	Frage	Wort
Fragezeichen	Frage	Zeichen
Fragmentierungsmethode	Fragmentierung	Methode
Frauchen	Frau	chen
Frauenmannschaft	Frau	Mannschaft
Frauenmilch	Frau	Milch
Frauentag	Frau	Tag
Frechdachs	frech	Dachs
Freibier	frei	Bier
Freiland	frei	Land
Freilandlabor	Freiland	Labor
Freimaurerin	Freimaurer	in
Freitagabend	Freitag	Abend
Freitagmittag	Freitag	Mittag
Freitagmorgen	Freitag	Morgen
Freitagnachmittag	Freitag	Nachmittag
Freitagnacht	Freitag	Nacht
Freitagsgebet	Freitag	Gebet
Freitagvormittag	Freitag	Vormittag
Freitod	frei	Tod
Freiwurflinie	Freiwurf	Linie
Freizeit	frei	Zeit
Freizeithemd	Freizeit	Hemd
Freizeitindustrie	Freizeit	Industrie
Freizeitpark	Freizeit	Park
Fremdherrschaft	fremd	Herrschaft
Fremdwort	fremd	Wort
Freudenmädchen	Freude	Mädchen
Freundin	Freund	in
Friedensunterhandlung	Frieden	Unterhandlung
Friedensverhandlung	Frieden	Verhandlung
Friedhofskapelle	Friedhof	Kapelle
Frikativlaut	Frikativ	Laut
Fristenbriefkasten	Frist	en	Briefkasten
Fristverlängerung	Frist	Verlängerung
Frontend	front	end
Froschperspektive	Frosch	Perspektive
Fruchtfleisch	Frucht	Fleisch
Fruchtfliege	Frucht	Fliege
Fruchtsaft	Frucht	Saft
Fruchtsalat	Frucht	Salat
Fruchtsäure	Frucht	Säure
Frustrationstoleranz	Frustration	Toleranz
Frühlingsanfang	Frühling	Anfang
Frühlingszwiebel	Frühling	Zwiebel
Frühstück	früh	Stück
Frühstücksbrettchen	Frühstück
Frühstücksbrot	Frühstück	Brot
Frühstücksei	Frühstück	Ei
Frühstücksradio	Frühstück	Radio
Fuchswelpe	Fuchs	Welpe
Fukushimakatastrophe	Fukushima	Katastrophe
Funktelefon	Funk	Telefon
Fusionsreaktor	Fusion	Reaktor
Fußabdruck	Fuss	Fuß	Abdruck
Fußball	Fuss	Fuß	Ball
Fußballer	Fußball	Fussball	-er
Fußballerin	-in	Fußballer	Fussballer
Fußballeuropameisterschaft	Fußball	Fussball	Europameisterschaft
Fußballfeld	Fußball	Feld	Fussball
Fußballmannschaft	Fußball	Fussball	Mannschaft
Fußballplatz	Fußball	Platz	Fussball
Fußballspiel	Spiel	Fußball	Fussball
Fußballspieler	Fußball	Spieler	Fussball
Fußballspielerin	-in	Fußballspieler	Fussballspieler
Fußballstadion	Fußball	Stadion	Fussball
Fußballtor	Fußball	Tor	Fussball
Fußballtrainer	Fußball	Trainer	Fussball
Fußballtrainerin	-in	Fußballtrainer	Fussballtrainer
Fußballtraining	Training	Fußball	Fussball
Fußballverein	Fußball	Verein	Fussball
Fußballweltmeisterschaft	Fußball	Fussball	Weltmeisterschaft
Fußboden	Fuss	Fuß	Boden
Fußbodenheizung	Fußboden	Heizung
Fußgängerbrücke	Fußgänger	Brücke
Fußgängerin	Fußgänger	in
Fußnote	Fuss	Fuß	Note
Fußsehne	Fuss	Fuß	Sehne
Fußtritt	Fuss	Fuß	Tritt
Fußverkehr	Fuss	Fuß	Verkehr
Fußweg	Fuss	Fuß	Weg
Fußzeile	Fuss	Fuß	Zeile
Färberin	Färber	in
Färöerin	Färöer	in
Fäustling	Faust	ling
Försterin	Förster	in
Fürstin	Fürst	in
Fürwort	für	Wort
Füßling	-ling	Fuß	Fuss
G-Saite	Saite
Galaxiehaufen	Galaxie	Haufen
Gamechanger	game	changer
Gangart	Gang	Art
Gangfenster	Gang	Fenster
Ganggestein	Gang	Gestein
Ganggrab	Gang	Grab
Gangsterin	Gangster	in
Gartenabfall	Garten	Abfall
Gartenerdbeere	Garten	Erdbeere
Gartengrasmücke	Garten	Grasmücke
Gartenhaus	Garten	Haus
Gartenhecke	Garten	Hecke
Gartenhimbeere	Garten	Himbeere
Gartenhäuschen	Garten	Häuschen
Gartenjahr	Garten	Jahr
Gartenkalender	Garten	Kalender
Gartenkolonie	Garten	Kolonie
Gartenkresse	Garten	Kresse
Gartenkultur	Garten	Kultur
Gartenkunst	Garten	Kunst
Gartenweg	Garten	Weg
Gartenzaun	Garten
Gasriese	Gas	Riese
Gastarbeiterin	Gastarbeiter	in
Gastgeberin	Gastgeber	in
Gastregisseur	Gast	Regisseur
Gastroenterologin	Gastroenterologe	in
Gastronomin	Gastronom	in
Gastzimmer	Gast	Zimmer
Gattungszahlwort	Gattung	Zahlwort
Gazastreifen	Gaza	Streifen
Gealbere	ge
Gebabbel	ge
Gebalge	ge
Geballer	ge
Gebarme	ge
Gebirgskamm	Gebirge	Kamm
Geburtshelfer	Geburt	Helfer
Geburtshelferin	Geburtshelfer	in
Geburtstag	Geburt	Tag
Geburtstagsfeier	Geburtstag	Feier
Geburtstagsgeschenk	Geburtstag	Geschenk
Geburtstagskuchen	Geburtstag	Kuchen
Geburtstagsparty	Geburtstag	Party
Gebärdensprachdolmetscherin	Gebärdensprachdolmetscher	in
Gedankenfreiheit	Gedanke	Freiheit
Gedankenstrich	Gedanke	Strich
Gedicht	ge
Gedrängel	ge
Gedudel	ge
Gefahrenabwehr	Gefahr	Abwehr
Gefahrensituation	Gefahr	en	Situation
Gefasel	ge
Gefauche	ge
Gegenspielerin	Gegenspieler	in
Gegenwartsform	Gegenwart	Form
Geheimdienst	geheim	Dienst
Gehweg	gehen	Weg
Gehörlosigkeit	gehörlos	igkeit
Gehörsinn	Gehör	Sinn
Geigenbauerin	Geigenbauer	in
Geigenharz	Geige	Harz
Geigensaite	Geige	Saite
Geigenspieler	Geige	Spieler
Geigenspielerin	Geigenspieler	in
Geigerin	Geiger	in
Geisterfahrerin	Geisterfahrer	in
Geldadel	Geld
Geldangebot	Geld	Angebot
Geldangelegenheit	Geld
Geldanleihe	Geld
Geldautomat	Geld	Automat
Geldmünze	Geld	Münze
Geldschein	Geld	Schein
Geldstück	Geld	Stück
Geldüberweisung	Geld	Überweisung
Gelegenheitsraucherin	Gelegenheitsraucher	in
Gelenkwelle	Gelenk	Welle
Geländeritt	Gelände	Ritt
Gemeindeacker	Gemeinde	Acker
Gemeindegebiet	Gemeinde	Gebiet
Gemeinschaftsdienst	Gemeinschaft	Dienst
Gemischtwarenladen	-n	Ware	Laden
Gemäldefoto	Gemälde	Foto
Gemüsesaft	Gemüse	Saft
Gemüsesuppe	Gemüse	Suppe
Genderstern	Gender	Stern
Gendersternchen	Genderstern	chen
Gendoping	Gen	Doping
Genealogin	Genealoge	in
Generaldirektorin	Generaldirektor	in
Generalin	General	in
Generalunternehmerin	Generalunternehmer	in
Genetikerin	Genetiker	in
Geochemikerin	Geochemiker	in
Geografie	geo	grafie
Geografiebuch	Geografie	Buch
Geografielehrer	Geografie	Lehrer
Geografin	Geograf	in
Geographin	Geograph	in
Geologin	Geologe	in
Geometerin	Geometer	in
Geomorphologin	Geomorphologe	in
Geophysikerin	Geophysiker	in
Georgierin	Georgier	in
Geruchssinn	Geruch	s	Sinn
Gesamtkost	gesamt	Kost
Gesamtvollstreckungsverfahren	Gesamtvollstreckung	Verfahren
Gesangbuch	Gesang	Buch
Geschirrspülmaschine	Geschirr	Spülmaschine
Geschirrtuch	Geschirr	Tuch
Geschlechtsakt	Geschlecht	Akt
Geschlechtsidentität	Geschlecht	Identität
Geschlechtswort	Geschlecht	Wort
Geschmackssinn	Geschmack	Sinn
Geschwindigkeitsbegrenzung	Geschwindigkeit	Begrenzung
Geschwindigkeitsbeschränkung	Geschwindigkeit	Beschränkung
Geschwindigkeitsüberschreitung	Geschwindigkeit	Überschreitung
Geschwisterkind	Geschwister	Kind
Geschwisterteil	Geschwister	Teil
Geschäftsbedingung	Geschäft	Bedingung
Geschäftsbereich	Geschäft	Bereich
Geschäftsfrau	Geschäft	Frau
Geschäftsführer	Geschäft	Führer
Geschäftsführerin	Geschäftsführer	in
Geschäftsidee	Geschäft	Idee
Geschäftsleitung	Geschäft	Leitung
Geschäftsmann	Geschäft	Mann
Geschäftsmodell	Geschäft	Modell
Geschäftsordnung	Geschäft	Ordnung
Geschäftsraum	Geschäft	Raum
Geschäftssitz	Geschäft	Sitz
Geschäftsstelle	Geschäft	Stelle
Gesellschaftsgefährlichkeit	gesellschaftsgefährlich	keit
Gesellschaftswissenschaftlerin	Gesellschaftswissenschaftler	in
Gesetzeshüter	Gesetz	Hüter
Gespielin	Gespiele	in
Gesprächsfaden	Gespräch	s	Faden
Gestaltungsfreiheit	Gestaltung	Freiheit
Gesundheit	gesund	heit
Gesundheitsamt	Gesundheit	Amt
Gesundheitsbehörde	Gesundheit	Behörde
Gesundheitseinrichtung	Gesundheit	Einrichtung
Gesundheitsinformation	Gesundheit	Information
Gesundheitsmanagement	Gesundheit	Management
Gesundheitssystem	Gesundheit	System
Gesundheitsvorschrift	Gesundheit	Vorschrift
Gesundheitsvorsorge	Gesundheit	Vorsorge
Gesundheitswesen	Gesundheit	Wesen
Gesundheitswissenschaft	Gesundheit	Wissenschaft
Getreidehalm	Getreide	Halm
Getreidekorn	Getreide	Korn
Getränkeautomat	Getränk	Automat
Gewerbefreiheit	Gewerbe	Freiheit
Gewerkschafterin	Gewerkschafter	in
Gewichtsabnahme	Gewicht	Abnahme
Gewichtszunahme	Gewicht	Zunahme
Gewinnerin	Gewinner	in
Gewittersturm	Gewitter	Sturm
Gewitterwolke	Gewitter	Wolke
Gewächshaus	Gewächs	Haus
Gewässerkunde	Gewässer	Kunde
Geäst	ge	Ast
Ghanaerin	Ghanaer	in
Gießener	Gießen	er
Gießenerin	Gießener	in
Giraffenbulle	Giraffe	Bulle
Gitarristin	Gitarrist	in
Gladiatorin	Gladiator	in
Glasbläserin	Glasbläser	in
Glasfenster	Glas	Fenster
Glasmalerin	Glasmaler	in
Glasnudel	Glas	Nudel
Glasschale	Glas	Schale
Glasscheibe	Glas	Scheibe
Gleichmaß	Maß
Gletscherbahn	Gletscher	Bahn
Glockenspeise	Glocke	Speise
Gläubigerin	Gläubiger	in
Glöckchen	Glocke	chen
Glückskatze	Glück	Katze
Glückspilz	Glück	s	Pilz
Glücksrad	Glück	Rad
Glücksspiel	Glück	Spiel
Glückwunsch	Glück	Wunsch
Golddraht	Gold	Draht
Goldlegierung	Gold	Legierung
Goldmedaille	Gold	Medaille
Golfstrom	Golf	Strom
Gouverneurin	Gouverneur	in
Grafikdesignerin	Grafikdesigner	in
Grafikerin	Grafiker	in
Grafologin	Grafologe	in
Grammatikerin	Grammatiker	in
Granatapfelbaum	Granatapfel	Baum
Grapefruitsaft	Grapefruit	Saft
Graphikerin	Graphiker	in
Graphologin	Graphologe	in
Graseule	Gras	Eule
Grasland	Gras	Land
Graveurin	Graveur	in
Gravitationsanomalie	Gravitation	Anomalie
Gravitationslinse	Gravitation	s	Linse
Grenzstein	Grenze	Stein
Grenzwissenschaft	Grenze	Wissenschaft
Gretchenfrage	Frage
Grießknödel	Grieß	Knödel
Grippeimpfung	Grippe	Impfung
Großbuchstabe	gross	groß	Buchstabe
Großdemonstration	gross	groß	Demonstration
Großeltern	Eltern	gross	groß
Großkind	Kind	gross	groß
Großmaul	gross	groß	Maul
Großmeisterin	Großmeister	in
Großmutter	gross	groß	Mutter
Großpackung	gross	groß	Packung
Großsohn	gross	groß	Sohn
Großstadt	gross	groß	Stadt
Großtochter	gross	groß	Tochter
Großvater	gross	groß	Vater
Grundlinie	Grund	Linie
Grundschullehrerin	Grundschullehrer	in
Grundschüler	Grundschule	er
Grundschülerin	Grundschüler	in
Grundstoffindustrie	Grundstoff	Industrie
Grundstrich	Grund	Strich
Grundstück	Grund	Stück
Grundstücksverkehrsgenehmigungszuständigkeitsübertragungsverordnung	Grundstück	Verkehr	Genehmigung	Zuständigkeit	Übertragung	Verordnung
Grundumsatz	Grund	Umsatz
Gruppenbildung	Gruppe	Bildung
Gruppenleiterin	Gruppenleiter	in
Gruppensiegerin	Gruppensieger	in
Grußformel	Gruß	Formel
Gründung	-ung	gründen
Grünfläche	grün	Fläche
Gulaschkanone	Gulasch	Kanone
Gummiadler	Gummi	Adler
Gummibär	Gummi	Bär
Gummiglocke	Gummi	Glocke
Gummihaut	Gummi	Haut
Gurkengewürz	Gurke	Gewürz
Gurkenglas	Gurke	Glas
Gurkensalat	Gurke	Salat
Gutachterin	Gutachter	in
Gymnasiallehrerin	Gymnasiallehrer	in
Gynäkologin	Gynäkologe	in
Gänsehaut	Gans	Haut
Gärtnerin	Gärtner	in
Gärtnermeister	Gärtner	Meister
Gästehandtuch	Gast	Handtuch
Gönnerin	Gönner	in
Götterspeise	Gott	Speise
Güterumschlag	Gut	Umschlag
Güterzug	Gut	Zug
HNO-Ärztin	HNO-Arzt	in
Haarbürste	Haar	Bürste
Haarspange	Haar	Spange
Hafenstadt	Hafen	Stadt
Haferbrei	Hafer	Brei
Haferdrink	Hafer	Drink
Hafermilch	Hafer	Milch
Hagelkorn	Hagel	Korn
Hakenkreuz	Haken	Kreuz
Hakennase	Haken	Nase
Halbgott	halb	Gott
Halbleiterindustrie	Halbleiter	Industrie
Halbwahrheit	halb	Wahrheit
Halbwissen	halb	Wissen
Halbzeitshow	Halbzeit	Show
Hallenkirche	Halle	Kirche
Hals-Nasen-Ohren-Ärztin	Hals-Nasen-Ohren-Arzt	in
Halskette	Hals	Kette
Halstuch	Hals	Tuch
Hamburger	Hamburg	er
Hammerhai	Hammer	Hai
Hamsterrad	Hamster	Rad
Hamsterratte	Hamster	Ratte
Handarbeiterin	Handarbeiter	in
Handball	Hand	Ball
Handballeuropameisterschaft	Handball	Europameisterschaft
Handballmannschaft	Handball	Mannschaft
Handballspielerin	Handballspieler	in
Handballweltmeisterschaft	Handball	Weltmeisterschaft
Handfläche	Hand	Fläche
Handrücken	Hand	Rücken
Handschrift	Hand	Schrift
Handschuh	Hand	Schuh
Handschuhkasten	Handschuh	Kasten
Handsäge	Hand	Säge
Handtasche	Hand	Tasche
Handtuch	Hand	Tuch
Handwerkerin	Handwerker	in
Harfenistin	Harfenist	in
Harnblase	Harn	Blase
Harnentleerung	Harn	Entleerung
Harnleiter	Harn	Leiter
Harnröhre	Harn	Röhre
Haschischraucherin	Haschischraucher	in
Haselmaus	Hasel	Maus
Hasenohr	Hase	Ohr
Hashtag	Hash	Tag
Hasskriminalität	Hass	Kriminalität
Hassverbrechen	Hass	Verbrechen
Haterin	Hater	in
Hauptdarstellerin	Hauptdarsteller	in
Haupthandlung	haupt	Handlung
Hauptsache	Haupt	Sache
Hauptschulabschluss	Hauptschule	Abschluss
Hauptwort	Haupt	Wort
Hausarbeit	Haus	Arbeit
Hausarzt	Haus	Arzt
Hausaufgabe	Haus	Aufgabe
Hausbesitzer	Haus	Besitzer
Hausbesuch	Haus	Besuch
Hausdach	Haus	Dach
Hauseigentümer	Haus	Eigentümer
Hausfrau	Haus	Frau
Haushaltsführung	Haushalt	Führung
Haushaltsordnung	Haushalt	Ordnung
Haushaltsplan	Haushalt	Plan
Haushaltsplanung	Haushalt	Planung
Haushälterin	Haushälter	in
Hauskaffee	Haus	Kaffee
Hauskatze	Haus	Katze
Hausmarke	Haus	Marke
Hausmeister	Haus	Meister
Hausmeisterin	Hausmeister	in
Hausmüll	Haus	Müll
Hausnummer	Haus	Nummer
Haustür	Haus	Tür
Hauswirtschaft	Haus	Wirtschaft
Hauswirtschaftsschule	Hauswirtschaft	Schule
Hawaii-Toast	Hawaii
Hawaiianerin	Hawaiianer	in
Hawaiigitarre	Hawaii	Gitarre
Hawaiihemd	Hawaii	Hemd
Hebamme	heben	Amme
Hebelarm	Hebel
Hebeldruck	Hebel
Hebelgesetz	Hebel
Hebelgriff	Hebel
Hebelkraft	Hebel
Hebelpresse	Hebel
Hebelwirkung	Hebel
Hefekuchen	Hefe	Kuchen
Hefeteig	Hefe	Teig
Heidelbeere	Heidel	Beere
Heilpraktikerin	Heilpraktiker	in
Heimatgalaxie	Heimat	Galaxie
Heimathafen	Heimat	Hafen
Heimatmuseum	Heimat	Museum
Heimatstadt	Heimat	Stadt
Heimkino	Heim	Kino
Heldin	Held	in
Heliumballon	Helium	Ballon
Henkerin	Henker	in
Hepatologin	Hepatologe	in
Herausgeberin	Herausgeber	in
Herbstanfang	Herbst	Anfang
Herbstferien	Herbst	Ferien
Herbstmonat	Herbst	Monat
Herbsttag	Herbst	Tag
Herdapfel	Herd	Apfel
Herkulesaufgabe	Aufgabe
Herrchen	Herr	chen
Herrenhausen-Stöcken	Herrenhausen	Stöcken
Herrentoilette	Herr	Toilette
Herrschaft	Herr	schaft
Herrscherin	Herrscher	in
Herstellergarantie	Hersteller	Garantie
Herstellerin	Hersteller	in
Herzchirurg	Herz	Chirurg
Herzchirurgin	Herzchirurg	in
Herzfrequenz	Herz	Frequenz
Herzklappenfehler	Herzklappe	Fehler
Herzmuskel	Herz	Muskel
Heteronormativität	hetero	Normativität
Hetzerin	Hetzer	in
Hexenjagd	Hexe	Jagd
Hexenmeister	Hexe	n	Meister
Hilfsarbeiterin	Hilfsarbeiter	in
Hilfskrankenschwester	Hilfe	Krankenschwester
Himbeereis	Himbeere	Eis
Himbeeressig	Himbeere	Essig
Himbeergelee	Himbeere	Gelee
Himbeergeschmack	Himbeere	Geschmack
Himbeerlimonade	Himbeere	Limonade
Himbeermarmelade	Himbeere	Marmelade
Himbeersaft	Himbeere	Saft
Himbeersirup	Himbeere	Sirup
Himbeerstrauch	Himbeere	Strauch
Himmelskugel	Himmel	Kugel
Himmelsrichtung	Himmel	Richtung
Himmelsscheibe	Himmel	Scheibe
Hineininterpretierung	hineininterpretieren	ung
Hinterarm	hinter	Arm
Hintergrund	hinter	Grund
Hintergrundmusik	Hintergrund	Musik
Hintergrundstrahlung	Hintergrund	Strahlung
Hinterland	hinter	Land
Hirschohr	Hirsch	Ohr
Hispanistin	Hispanist	in
Historienmaler	Historie
Historienmalerin	Historienmaler	in
Historiker	Historie
Historikerin	Historiker	in
Hitlerbärtchen	Hitler	Bärtchen
Hitzefrei	Hitze	frei
Hitzegrad	Hitze	Grad
Hitzequelle	Hitze	Quelle
Hochgeschwindigkeitsstrecke	Hochgeschwindigkeit	Strecke
Hochgeschwindigkeitsverkehr	Hochgeschwindigkeit	Verkehr
Hochgeschwindigkeitszug	Hochgeschwindigkeit	Zug
Hochkultur	hoch	Kultur
Hochschulbibliothek	Hochschule	Bibliothek
Hochschullehrerin	Hochschullehrer	in
Hochschulzugangsberechtigung	Hochschule	Zugangsberechtigung
Hochspannungskabel	Hochspannung	Kabel
Hochwasserkatastrophe	Hochwasser	Katastrophe
Hochwasserschutz	Hochwasser	Schutz
Hochzeit	hoch	Zeit
Hofstaat	Hof	Staat
Hohlwelle	hohl	Welle
Hollandrad	Holland	Rad
Holzblasinstrument	Holz	Blasinstrument
Holzbohle	Holz	Bohle
Holzverbindung	Holz	Verbindung
Holzwirtschaft	Holz	Wirtschaft
Hongkongerin	Hongkonger	in
Honigkuchen	Honig	Kuchen
Horcherin	Horcher	in
Hornblende	Horn	Blende
Hornblendegranit	Hornblende	Granit
Hornhaut	Horn	Haut
Hornistin	Hornist	in
Horrorfilm	Horror	Film
Hosentasche	Hose	Tasche
Hosenträger	Hose	Träger
Hotelierin	Hotelier	in
Hotelmanager	Hotel	Manager
Hufschmied	Huf	Schmied
Hufschmiedin	Hufschmied	in
Humanistin	Humanist	in
Hundchen	Hund	chen
Hundeabteil	Hund	Abteil
Hundeauge	Hund	Auge
Hundegebell	Hund	Gebell
Hundegekläff	Hund	Gekläff
Hundehaufen	Hund	Haufen
Hundehütte	Hund	Hütte
Hundekacke	Hund	e	Kacke
Hundekot	Hund	Kot
Hundeleine	Hund	Leine
Hundename	Hund	Name
Hundeohr	Hund	Ohr
Hunderteuroschein	hundert	Euro	Schein
Hundertmarkschein	hundert	Mark	Schein
Hundescheiße	Hund	Scheiße
Hundesohn	Hund	Sohn
Hundetoilette	Hund	Toilette
Hundevieh	Hund	Vieh
Hundsstern	Hund	s	Stern
Hungerlohn	Hunger	Lohn
Hungersträhne	Hunger	Strähne
Hurenkind	Hure	Kind
Hurensohn	Hure	Sohn
Hutablage	Hut	Ablage
Hydrant	-ant	hydrieren
Hähnchenkeule	Hähnchen	Keule
Hämatologin	Hämatologe	in
Härchen	Haar	chen
Höchstmaß	Maß
Höckernase	Höcker	Nase
Hörerin	Hörer	in
Höschen	Hose	chen
Hübnerschaft	Hübner	schaft
Hüftgelenk	Hüfte	Gelenk
Hüftgelenksprothese	Hüftgelenk	Prothese
Hüftgelenksprothesenimplantation	Hüftgelenksprothese	Implantation
Hühnerauge	Huhn	Auge
Hühnerei	Huhn	Ei
Hündchen	Hund	chen
Hündin	Hund	in
Hütchenspielerin	Hütchenspieler	in
Idiotin	Idiot	in
Illustratorin	Illustrator	in
Imkerin	Imker	in
Immigrantin	Immigrant	in
Immobilienfinanzierung	Immobilie	n	Finanzierung
Immobilienmaklerin	Immobilienmakler	in
Immunologin	Immunologe	in
Impaktkrater	Impakt	Krater
Impfstofflieferung	Impfstoff	Lieferung
Impfstoffmangel	Impfstoff	Mangel
Inderin	Inder	in
Indianerin	Indianer	in
Indonesierin	Indonesier	in
Industriepolitik	Industrie	Politik
Influencerin	Influencer	in
Influenzapandemieplan	Influenza	Pandemie	Plan
Informatikerin	Informatiker	in
Informationsfreiheit	Information	Freiheit
Informationsfreiheitsgesetz	Informationsfreiheit	Gesetz
Informationsmaterial	Information	Material
Informationsquelle	Information	Quelle
Informationssicherheit	Information	Sicherheit
Informationstechnologie	Information	Technologie
Informationswirtschaft	Information	Wirtschaft
Ingenieurin	Ingenieur	in
Ingenieurstudium	Ingenieur	Studium
Ingenieurwissenschaft	Ingenieur	Wissenschaft
Inhaberin	Inhaber	in
Inhaltsverzeichnis	Verzeichnis	Verzeichniß	Inhalt
Initiatorin	Initiator	in
Innenministerin	Innenminister	in
Insektenhotel	Insekt	Hotel
Insektenstich	Insekt	Stich
Inselbevölkerung	Insel	Bevölkerung
Inselgruppe	Insel	Gruppe
Inselstaat	Insel	Staat
Insiderinformation	Insider	Information
Insolvenzverwalterin	Insolvenzverwalter	in
Instrukteurin	Instrukteur	in
Instruktorin	Instruktor	in
Instrumentalistin	Instrumentalist	in
Instrumentatorin	Instrumentator	in
Instrumentenbauerin	Instrumentenbauer	in
Instrumententasche	Instrument	Tasche
Insulanerin	Insulaner	in
Intelligenzalter	Intelligenz	Alter
Intelligenzbestie	Intelligenz	Bestie
Intelligenzblatt	Intelligenz	Blatt
Intelligenzbolzen	Intelligenz	bolzen
Intelligenzfrage	Intelligenz	Frage
Intelligenzgrad	Intelligenz	Grad
Intelligenzkarte	Intelligenz	Karte
Intelligenzleistung	Intelligenz	Leistung
Intelligenzler	Intelligenz	ler
Intelligenzminderung	Intelligenz	Minderung
Intelligenzprobe	Intelligenz	Probe
Intelligenzprüfung	Intelligenz	Prüfung
Intelligenzrente	Intelligenz	Rente
Intelligenzstufe	Intelligenz	Stufe
Intelligenztest	Intelligenz	Test
Interlinguistin	Interlinguist	in
Internationalisierungsstrategie	Internationalisierung	Strategie
Internetadresse	Internet	Adresse
Internetdienst	Internet	Dienst
Internetzugang	Internet	Zugang
Internistin	Internist	in
Interpunktionszeichen	Interpunktion	Zeichen
Invasionsbiologie	Invasion	s	Biologie
Investmentgesellschaft	Investment	Gesellschaft
Investorin	Investor	in
Irakerin	Iraker	in
Iranerin	Iraner	in
Irländerin	Irländer	in
Irrglaube	irren	Glaube
Islamismus	Islam	ismus
Islamwissenschaft	Islam	Wissenschaft
Isländerin	Isländer	in
Israelin	Israeli	in
Israelitin	Israelit	in
Italienerin	Italiener	in
Jagdgehege	Jagd	Gehege
Jagdschloss	Schloss
Jagdunfall	Jagd	Unfall
Jahrbuch	Jahr	Buch
Jahresbericht	Jahr	Bericht
Jahresende	Jahr	Ende
Jahresgehalt	Jahr
Jahreslohn	Jahr	Lohn
Jahresrückblick	Jahr	Rückblick
Jahrestreffen	Jahr	Treffen
Jahreswechsel	Jahr	Wechsel
Jahreswende	Jahr	Wende
Jahreszeit	Jahr	Zeit
Jahrgang	Jahr	Gang
Jahrhundertaufgabe	Jahrhundert	Aufgabe
Jahrhunderthochwasser	Jahrhundert	Hochwasser
Jahrhundertprojekt	Jahrhundert	Projekt
Jahrmilliarde	Jahr	Milliarde
Jahrtausendwende	Jahrtausend	Wende
Jamaikanerin	Jamaikaner	in
Jamaikerin	Jamaiker	in
Januarausgabe	Januar	Ausgabe
Januartag	Januar	Tag
Januarwoche	Januar	Woche
Japaner	Japan	er
Japanerin	Japaner	in
Japanologin	Japanologe	in
Jazzband	Jazz	Band
Jazzclub	Jazz	Club
Jazzfestival	Jazz	Festival
Jazzmusikerin	Jazzmusiker	in
Jemenitin	Jemenit	in
Jenaerin	Jenaer	in
Jenenserin	Jenenser	in
Jochbein	Joch	Bein
Joghurtbecher	Joghurt	Becher
Jogurtbecher	Jogurt	Becher
Johannisbeermarmelade	Johannisbeere	Marmelade
Johnny-Mütze	Johnny	Mütze
Jordanier	Jordanien	er
Jordanierin	Jordanier	in
Journalismus	Journal	ismus
Journalistin	Journalist	in
Judenhass	Jude	Hass
Judenpogrom	Jude	Pogrom
Judenstern	Jude	Stern
Judenverfolgung	Jude	Verfolgung
Jugendarbeitslosigkeit	Jugend	Arbeitslosigkeit
Jugendbibliothek	Jugend	Bibliothek
Jugendchor	Jugend	Chor
Jugendforschung	Jugend	Forschung
Jugendgang	Jugend	Gang
Jugendminister	Jugend	Minister
Jugendmuseum	Jugend	Museum
Jugendorchester	Jugend	Orchester
Jugendtag	Jugend	Tag
Jugoslawin	Jugoslawe	in
Jungenhorde	Junge
Juniorenmeisterschaft	Junior	Meisterschaft
Juristin	Jurist	in
Just-in-time-Compiler	just in time	Compiler
Justizminister	Justiz	Minister
Justizministerin	Justizminister	in
Jutebeutel	Jute	Beutel
Jutesack	Jute	Sack
Juwelierin	Juwelier	in
Kabelsalat	Kabel	Salat
Kabeltrasse	Kabel	Trasse
Kabukitheater	Kabuki	Theater
Kaffeeautomat	Kaffee	Automat
Kaffeebecher	Kaffee	Becher
Kaffeebohne	Kaffee	Bohne
Kaffeegenuss	Kaffee	Genuss
Kaffeegesellschaft	Kaffee	Gesellschaft
Kaffeekuchen	Kaffee	Kuchen
Kaffeemaschine	Kaffee	Maschine
Kaffeepreis	Kaffee	Preis
Kaffeesatz	Kaffee	Satz
Kaffeesatzleser	Kaffeesatz	Leser
Kaffeesatzleserei	Kaffeesatz	Leserei
Kaffeesieb	Kaffee	Sieb
Kaffeetrinken	Kaffee	Trinken
Kaffeetrinker	Kaffee	Trinker
Kaiserbrötchen	Kaiser	Brötchen
Kaiserin	Kaiser	in
Kaiserreich	Kaiser	Reich
Kaisersemmel	Kaiser	Semmel
Kakaobohne	Kakao	Bohne
Kakaobutter	Kakao	Butter
Kalendereintrag	Kalender	Eintrag
Kalendermonat	Kalender	Monat
Kalenderwoche	Kalender	Woche
Kalibrierung	kalibrieren	ung
Kalibrierungsnummer	Kalibrierung	Nummer
Kalibrierungsversion	Kalibrierung	Version
Kalkglimmer	Kalk	Glimmer
Kalkspat	Kalk	Spat
Kalorienbombe	Kalorie	Bombe
Kambodschaner	Kambodscha	er
Kambodschanerin	Kambodschaner	in
Kamelohr	Kamel	Ohr
Kamerafrau	Kamera	Frau
Kameruner	Kamerun	er
Kamerunerin	Kameruner	in
Kamilleextrakt	Kamille	Extrakt
Kamillentee	Kamille	Tee
Kammermusik	Kammer	Musik
Kammerorchester	Kammer	Orchester
Kampfansage	Kampf	Ansage
Kampfgas	Kampf	Gas
Kampfmittelbeseitigungsdienst	Kampfmittelbeseitigung	Dienst
Kampfpanzer	Kampf	Panzer
Kampfsportlerin	Kampfsportler	in
Kampfwagen	Kampf	Wagen
Kampfzone	Kampf	Zone
Kanadierin	Kanadier	in
Kaninchenbau	Kaninchen	Bau
Kaninchenloch	Kaninchen	Loch
Kaninchenohr	Kaninchen	Ohr
Kannibalin	Kannibale	in
Kanonenkugel	Kanone	Kugel
Kantenlänge	Kante	Länge
Kantorin	Kantor	in
Kanufahrer	Kanu	Fahrer
Kanufahrerin	Kanufahrer	in
Kanzlerin	Kanzler	in
Kapellmeisterin	Kapellmeister	in
Kapitalmarkt	Kapital	Markt
Kapitalmarktexperte	Kapitalmarkt	Experte
Kapitulationserklärung	Kapitulation	s	Erklärung
Kapitälchen	Kapital	chen
Kapitänin	Kapitän	in
Karaokebar	Karaoke	Bar
Kardiogramm	kardio	gramm
Kardiologin	Kardiologe	in
Kargheit	karg	heit
Karikaturistin	Karikaturist	in
Karnevalistin	Karnevalist	in
Kartei	Karte	ei
Karteileiche	Kartei	Leiche
Karteireiter	Kartei	Reiter
Kartenspiel	Karte
Kartenspieler	Karte	Spieler
Kartenspielerin	Kartenspieler	in
Kartoffelferien	Kartoffel	Ferien
Kartoffelpfannkuchen	Kartoffel	Pfannkuchen
Kartoffelpüree	Kartoffel	Püree
Kartoffelsalat	Kartoffel	Salat
Kartoffelschale	Kartoffel	Schale
Kartoffelschäler	Kartoffel	Schäler
Kartoffelsuppe	Kartoffel	Suppe
Kartografin	Kartograf	in
Kartographin	Kartograph	in
Kasachin	Kasache	in
Kassiererin	Kassierer	in
Kastanienallee	Kastanie	Allee
Katastrophenschutz	Katastrophe	Schutz
Katechetin	Katechet	in
Katzenauge	Katze	Auge
Katzenbaum	Katze	Baum
Katzengesicht	Katze	Gesicht
Katzenhai	Katze	Hai
Katzenklappe	Katze
Katzenklo	Katze	Klo
Katzenkonzert	Katze	Konzert
Katzenkraut	Katze	Kraut
Katzenmusik	Katze	Musik
Katzenohr	Katze	Ohr
Katzenpfote	Katze	n	Pfote
Katzensprung	Katze	n	Sprung
Katzentoilette	Katze	Toilette
Katzenvideo	Katze	Video
Kaufkraftverlust	Kaufkraft	Verlust
Keeperin	Keeper	in
Kegelbahn	Kegel	Bahn
Kegelkugel	Kegel	Kugel
Kehlchen	Kehle	chen
Kehrbesen	kehren	Besen
Keilschrift	Keil	Schrift
Keilwelle	Keil	Welle
Keksdose	Keks	Dose
Kelchblatt	Kelch	Blatt
Kellnerin	Kellner	in
Kernfrucht	Kern	Frucht
Kernfusion	Kern	Fusion
Kernfusionsreaktor	Kernfusion	Reaktor
Kerngeschäft	Kern	Geschäft
Kernphysikerin	Kernphysiker	in
Kettenbrief	Kette	Brief
Kettenkarussell	Kette	Karussell
Kettenlänge	Kette	Länge
Kettenraucherin	Kettenraucher	in
Kettenreaktion	Kette	Reaktion
Kettenöl	Kette	Öl
Keyboarderin	Keyboarder	in
Kicker	kicken	er
Kickerin	Kicker	in
Kielerin	Kieler	in
Kieselstein	Kiesel	Stein
Kilometer	kilo	Meter
Kilonewton	kilo	Newton
Kindbett	Kind	Bett
Kindbettfieber	Kindbett	Fieber
Kindchen	Kind	chen
Kindchenschema	Kindchen	Schema
Kindelbier	Kindel	Bier
Kinderabzug	Kind	Abzug
Kinderangebot	Kind	Angebot
Kinderarbeit	Kind	Arbeit
Kinderarmut	Kind	Armut
Kinderarzt	Kind	Arzt
Kinderaufzug	Kind	Aufzug
Kinderauge	Kind	Auge
Kinderausspeisung	Kind	Ausspeisung
Kinderauto	Kind	Auto
Kinderbadewanne	Kind	Badewanne
Kinderball	Kind	Ball
Kinderballett	Kind	Ballett
Kinderballon	Kind	Ballon
Kinderbecher	Kind	Becher
Kinderbeihilfe	Kind	Beihilfe
Kinderbekleidung	Kind	Bekleidung
Kinderbelustigung	Kind	Belustigung
Kinderbescherung	Kind	Bescherung
Kinderbesteck	Kind	Besteck
Kinderbetreuung	Kind	Betreuung
Kinderbetreuungseinrichtung	Kinderbetreuung	Einrichtung
Kinderbetreuungskosten	Kinderbetreuung	Kosten
Kinderbett	Kind	Bett
Kinderbewahranstalt	Kind	Bewahranstalt
Kinderbibel	Kind	Bibel
Kinderbibliothek	Kind	Bibliothek
Kinderbild	Kind	Bild
Kinderblick	Kind	Blick
Kinderbolzen	Kind	Bolzen
Kinderbrei	Kind	Brei
Kinderbrust	Kind	Brust
Kinderbräune	Kind	Bräune
Kinderbuch	Kind	Buch
Kinderbuchautor	Kinderbuch	Autor
Kinderbuchautorin	Kinderbuchautor	in
Kinderbuchladen	Kind	Buchladen
Kinderbühne	Kind	Bühne
Kinderchor	Kind	Chor
Kinderclub	Kind	Club
Kinderdorf	Kind	Dorf
Kinderdrachen	Kind	Drachen
Kinderehe	Kind	Ehe
Kinderei	Kind	erei
Kindereinrichtung	Kind	Einrichtung
Kinderelend	Kind	Elend
Kinderermäßigung	Kind	Ermäßigung
Kinderernährung	Kind	Ernährung
Kindererziehung	Kind	Erziehung
Kindererziehungszeit	Kindererziehung	Zeit
Kinderfacharzt	Kind	Facharzt
Kinderfahrrad	Kind	Fahrrad
Kinderfasching	Kind	Fasching
Kinderfassung	Kind	Fassung
Kinderferienlager	Kind	Ferienlager
Kinderfernsehen	Kind	Fernsehen
Kinderfest	Kind	Fest
Kinderfilm	Kind	Film
Kinderfrau	Kind	Frau
Kinderfreibetrag	Kind	Freibetrag
Kinderfreund	Kind	Freund
Kinderfreundin	Kinderfreund	in
Kinderfreundlichkeit	kinderfreundlich	keit
Kinderfräulein	Kind	Fräulein
Kinderfunk	Kind	Funk
Kinderfuß	Fuss	Kind	Fuß
Kindergarten	Kind	Garten
Kindergartenalter	Kindergarten	Alter
Kindergartengruppe	Kindergarten	Gruppe
Kindergartenkind	Kindergarten	Kind
Kindergartenplatz	Kindergarten	Platz
Kindergartenschließung	Kindergarten	Schließung
Kindergeburtstag	Kind	Geburtstag
Kindergeld	Kind	Geld
Kindergelderhöhung	Kindergeld	Erhöhung
Kindergenesungsheim	Kind	Genesungsheim
Kindergeplärre	Kind	Geplärre
Kindergeschichte	Kind	Geschichte
Kindergeschrei	Kind	Geschrei
Kindergeschwätz	Kind	Geschwätz
Kindergesicht	Kind	Gesicht
Kindergesundheit	Kind	Gesundheit
Kindergetrappel	Kind	Getrappel
Kindergewimmel	Kind	Gewimmel
Kinderglaube	Kind	Glaube
Kinderglauben	Kind	Glauben
Kinderglück	Kind	Glück
Kindergottesdienst	Kind	Gottesdienst
Kindergrab	Kind	Grab
Kindergruppe	Kind	Gruppe
Kindergymnastik	Kind	Gymnastik
Kindergärtnerin	Kindergärtner	in
Kinderhand	Kind	Hand
Kinderhandel	Kind	Handel
Kinderhandschrift	Kind	Handschrift
Kinderhaus	Kind	Haus
Kinderheilkunde	Kind	Heilkunde
Kinderheilstätte	Kind	Heilstätte
Kinderheim	Kind	Heim
Kinderheirat	Kind	Heirat
Kinderhilfe	Kind	Hilfe
Kinderhilfswerk	Kind	Hilfswerk
Kinderhort	Kind	Hort
Kinderhose	Kind	Hose
Kinderhospiz	Kind	Hospiz
Kinderjubel	Kind	Jubel
Kinderkalender	Kind	Kalender
Kinderkanal	Kind	Kanal
Kinderkino	Kind	Kino
Kinderkirche	Kind	Kirche
Kinderklapper	Kind	Klapper
Kinderkleidung	Kind	Kleidung
Kinderklinik	Kind	Klinik
Kinderklub	Kind	Klub
Kinderkonfektion	Kind	Konfektion
Kinderkopf	Kind	Kopf
Kinderkorb	Kind	Korb
Kinderkram	Kind	Kram
Kinderkrankheit	Kind	Krankheit
Kinderkreuzzug	Kind	Kreuzzug
Kinderkriminalität	Kind	Kriminalität
Kinderkrippe	Kind	Krippe
Kinderkutsche	Kind	Kutsche
Kinderladen	Kind	Laden
Kinderland	Kind	Land
Kinderlaune	Kind	Laune
Kinderleben	Kind	Leben
Kinderleiche	Kind	Leiche
Kinderlesesaal	Kind	Lesesaal
Kinderlexikon	Kind	Lexikon
Kinderlied	Kind	Lied
Kinderliteratur	Kind	Literatur
Kinderlosigkeit	kinderlos	igkeit
Kinderlotto	Kind	Lotto
Kinderlähmung	Kind	Lähmung
Kinderlärm	Kind	Lärm
Kinderlätzchen	Kind	Lätzchen
Kindermantel	Kind	Mantel
Kindermehl	Kind	Mehl
Kindermesse	Kind	Messe
Kindermilch	Kind	Milch
Kindermode	Kind	Mode
Kindermund	Kind	Mund
Kindermädchen	Kind	Mädchen
Kindermärchen	Kind	Märchen
Kindermöbel	Kind	Möbel
Kindernahrung	Kind	Nahrung
Kinderoper	Kind	Oper
Kinderorchester	Kind	Orchester
Kinderparadies	Kind	Paradies
Kinderparlament	Kind	Parlament
Kinderpflege	Kind	Pflege
Kinderpflegerin	Kinderpfleger	in
Kinderpistole	Kind	Pistole
Kinderpornografie	Kind	Pornografie
Kinderpornographie	Kind	Pornographie
Kinderportion	Kind	Portion
Kinderpossen	Kind	Possen
Kinderprogramm	Kind	Programm
Kinderprostitution	Kind	Prostitution
Kinderpsychiater	Kind	Psychiater
Kinderpsychiatrie	Kind	Psychiatrie
Kinderpsychologe	Kind	Psychologe
Kinderpsychologie	Kind	Psychologie
Kinderrad	Kind	Rad
Kinderrassel	Kind	Rassel
Kinderrecht	Kind	Recht
Kinderreichtum	Kind	Reichtum
Kinderreim	Kind	Reim
Kinderroller	Kind	Roller
Kindersarg	Kind	Sarg
Kinderschar	Kind	Schar
Kinderschlafzimmer	Kind	Schlafzimmer
Kinderschlitten	Kind	Schlitten
Kinderschrift	Kind	Schrift
Kinderschuh	Kind	Schuh
Kinderschule	Kind	Schule
Kinderschutz	Kind	Schutz
Kinderschwester	Kind	Schwester
Kinderschänder	Kind	Schänder
Kinderschürze	Kind	Schürze
Kinderseele	Kind	Seele
Kindersendung	Kind	Sendung
Kindersicherung	Kind	Sicherung
Kindersitz	Kind	Sitz
Kindersocke	Kind	Socke
Kinderspeisung	Kind	Speisung
Kinderspiel	Kind	Spiel
Kinderspielzeug	Kind	Spielzeug
Kinderspital	Kind	Spital
Kindersportschule	Kind	Sportschule
Kindersprache	Kind	Sprache
Kindersterblichkeit	Kind	Sterblichkeit
Kinderstimme	Kind	Stimme
Kinderstimmenimitation	Kinderstimme	Imitation
Kinderstimmenimitator	Kinderstimme	Imitator
Kinderstrumpf	Kind	Strumpf
Kinderstube	Kind	Stube
Kinderstuhl	Kind	Stuhl
Kinderstück	Kind	Stück
Kindertag	Kind	Tag
Kindertageseinrichtung	Kind	Tageseinrichtung
Kindertagesstätte	Kind	Tagesstätte
Kindertheater	Kind	Theater
Kindertrompete	Kind	Trompete
Kinderträne	Kind	Träne
Kindertute	Kind	Tute
Kindertümlichkeit	kindertümlich	keit
Kinderuhr	Kind	Uhr
Kinderuniversität	Kind	Universität
Kindervelo	Kind	Velo
Kinderverschickung	Kind	Verschickung
Kindervorstellung	Kind	Vorstellung
Kinderwagen	Kind	Wagen
Kinderwagengarnitur	Kinderwagen	Garnitur
Kinderwarenhaus	Kind	Warenhaus
Kinderwelt	Kind	Welt
Kinderwiege	Kind	Wiege
Kinderwochenheim	Kind	Wochenheim
Kinderwunsch	Kind	Wunsch
Kinderwäsche	Kind	Wäsche
Kinderzahl	Kind	Zahl
Kinderzahnheilkunde	Kind	Zahnheilkunde
Kinderzeichnung	Kind	Zeichnung
Kinderzeit	Kind	Zeit
Kinderzeitschrift	Kind	Zeitschrift
Kinderzeitung	Kind	Zeitung
Kinderzimmer	Kind	Zimmer
Kinderzoo	Kind	Zoo
Kinderzulage	Kind	Zulage
Kinderzuschlag	Kind	Zuschlag
Kinderärztin	Kinderarzt	in
Kindesabtreibung	Kind	Abtreibung
Kindesalter	Kind	Alter
Kindesaussetzung	Kind	Aussetzung
Kindesbeine	Kind	Bein
Kindesentführung	Kind	Entführung
Kindesentziehung	Kind	Entziehung
Kindeshandel	Kind	Handel
Kindesheirat	Kind	Heirat
Kindeskind	Kind
Kindesliebe	Kind	Liebe
Kindesmissbrauch	Kind	Missbrauch
Kindesmisshandlung	Kind	Misshandlung
Kindesmord	Kind	Mord
Kindesmuhme	Kind	Muhme
Kindesmutter	Kind	Mutter
Kindesmörder	Kind	Mörder
Kindesmörderin	Kindesmörder	in
Kindesnöte	Kind	Not
Kindespflege	Kind	Pflege
Kindespflicht	Kind	Pflicht
Kindesraub	Kind	Raub
Kindesschänder	Kind	Schänder
Kindestod	Kind	Tod
Kindestötung	Kind	Tötung
Kindesunterschiebung	Kind	Unterschiebung
Kindesvater	Kind	Vater
Kindesvermögen	Kind	Vermögen
Kindeswohl	Kind	Wohl
Kindeswohlgefährdung	Kindeswohl	Gefährdung
Kindeszeit	Kind	Zeit
Kindfrau	Kind	Frau
Kindheit	Kind	heit
Kindheitseindruck	Kindheit	Eindruck
Kindheitsepisode	Kindheit	Episode
Kindheitserfahrung	Kindheit	Erfahrung
Kindheitserinnerung	Kindheit	Erinnerung
Kindheitserlebnis	Kindheit	Erlebnis
Kindheitsforschung	Kindheit	Forschung
Kindheitsgefährte	Kindheit	Gefährte
Kindheitsschwarm	Kindheit	Schwarm
Kindheitstag	Kindheit	Tag
Kindheitstraum	Kindheit	Traum
Kindlein	Kind	lein
Kindlichkeit	kindlich	keit
Kindsbewegung	Kind	Bewegung
Kindschaft	Kind	schaft
Kindschaftsrecht	Kindschaft	Recht
Kindsfrau	Kind	Frau
Kindskopf	Kind	Kopf
Kindslage	Kind	Lage
Kindsmagd	Kind	Magd
Kindsmord	Kind	Mord
Kindsmörder	Kind	Mörder
Kindspflege	Kind	Pflege
Kindsraub	Kind	Raub
Kindsteil	Kind	Teil
Kindstod	Kind	Tod
Kindstötung	Kind	Tötung
Kindsvater	Kind	Vater
Kindswohl	Kind	Wohl
Kindswohlgefährdung	Kindswohl	Gefährdung
Kindtaufe	Kind	Taufe
Kirchenbuch	Kirche	Buch
Kirchengeschichte	Kirche	Geschichte
Kirchenhistorikerin	Kirchenhistoriker	in
Kirchenmusik	Kirche	Musik
Kirchenschiff	Kirche	Schiff
Kirchrode-Bemerode-Wülferode	Kirchrode	Bemerode	Wülferode
Kirgisin	Kirgise	in
Kirmeskuchen	Kirmes	Kuchen
Kirschbaum	Kirsche	Baum
Kirschbaumholz	Kirschbaum	Holz
Kirschblüte	Kirsche	Blüte
Kirschkuchen	Kirsche	Kuchen
Kirschlikör	Kirsche	Likör
Kirschmarmelade	Kirsch	Marmelade
Kirschsaft	Kirsche	Saft
Klarheit	klar	heit
Klarinettistin	Klarinettist	in
Klassenarbeit	Klasse	Arbeit
Klassenlehrer	Klasse	Lehrer
Klassenzimmer	Klasse	Zimmer
Klaviermusik	Klavier	Musik
Klavierspieler	Klavier	Spieler
Klavierspielerin	Klavierspieler	in
Kleidchen	Kleid	chen
Kleinbuchstabe	klein	Buchstabe
Kleinbär	klein	Bär
Kleinkind	klein	Kind
Kleinplanet	klein	Planet
Kleinstaat	klein	Staat
Klempnerin	Klempner	in
Klickibunti	Klick	i	bunt
Klientin	Klient	in
Klimaaktivist	Klima	Aktivist
Klimaaktivistin	Klimaaktivist	in
Klimaanlage	Klima	Anlage
Klimaanpassung	Klima	Anpassung
Klimaanpassungsstrategie	Klimaanpassung	Strategie
Klimaforschung	Klima	Forschung
Klimagas	Klima	Gas
Klimageld	Klima	Geld
Klimakammer	Klima	Kammer
Klimakatastrophe	Klima	Katastrophe
Klimakipppunkt	Klima	Kipppunkt
Klimakrise	Klima	Krise
Klimaneutralität	Klima	Neutralität
Klimanotstand	Klima
Klimapolitik	Klima	Politik
Klimaschutz	Klima	Schutz
Klimaschutzmaßnahme	Klimaschutz	Maßnahme
Klimaschutzpolitik	Klimaschutz	Politik
Klimasystem	Klima	System
Klimawandel	Klima	Wandel
Klobrille	Klo	Brille
Klobürste	Klo	Bürste
Klopapier	Klo	Papier
Klopapiermangel	Klopapier	Mangel
Klopapierrolle	Klopapier	Rolle
Klopper	kloppen	er
Kläffer	kläffen	er
Knackwurst	Knack	Wurst
Kniestrumpf	Knie	Strumpf
Kniewelle	Knie	Welle
Knoblauchbutter	Knoblauch	Butter
Knoblauchpresse	Knoblauch	Presse
Knoblauchöl	Knoblauch	Öl
Knotenpunkt	Knoten	Punkt
Koalitionsbildung	Koalition	Bildung
Koalitionsfreiheit	Koalition	Freiheit
Koalitionspartei	Koalition	Partei
Koalitionsvertrag	Koalition	Vertrag
Koalitionsvertragsentwurf	Koalitionsvertrag	s	Entwurf
Kochbanane	kochen	Banane
Kochfrau	Koch	Frau
Kochstube	kochen	Stube
Kofferdamm	Koffer	Damm
Kofferraum	Koffer	Raum
Kohlendioxid	Kohle
Kohlenstoff	Kohle	Stoff
Kohlenstoffdioxid	Kohlenstoff	Dioxid
Kohlenstoffzyklus	Kohlenstoff	Zyklus
Kohlensäure	Kohle	Säure
Kohlenwasserstoff	Kohle	Wasserstoff
Kohlenwasserstoffverbindung	Kohlenwasserstoff	Verbindung
Kohleofen	Kohle	Ofen
Kollaboration	kollaborieren	-ation
Kollektivierung	kollektivieren	ung
Koloristin	Kolorist	in
Komasaufen	Koma	Saufen
Komikerin	Komiker	in
Kommandeurin	Kommandeur	in
Kommandobrücke	Kommando	Brücke
Kommandozeile	Kommando	Zeile
Kommunalpolitikerin	Kommunalpolitiker	in
Kommunikationsoffizierin	Kommunikation	Offizierin
Kommunikationswissenschaft	Kommunikation	Wissenschaft
Kompaktkassette	kompakt	Kassette
Komparativsatz	Komparativ	Satz
Kompetenzkompetenz	Kompetenz
Komponistin	Komponist	in
Kompressionsartefakt	Kompression	s	Artefakt
Kompressionsstrumpf	Kompression	s	Strumpf
Kondensmilch	kondensieren	Milch
Konditorin	Konditor	in
Konjunktivsatz	Konjunktiv	Satz
Konjunkturzahl	Konjunktur	Zahl
Konservendose	Konserve	Dose
Konsolenspiel	Konsole	Spiel
Konstrukteurin	Konstrukteur	in
Kontaktgruppe	Kontakt	Gruppe
Kontaktstelle	Kontakt	Stelle
Kontrabassistin	Kontrabassist	in
Kontrastmittelinjektion	Kontrastmittel	Injektion
Kontrollzentrum	Kontrolle	Zentrum
Konzentrationslager	Konzentration	Lager
Konzeptkünstler	Konzept	Künstler
Konzeptkünstlerin	Konzeptkünstler	in
Konzernteil	Konzern	Teil
Kooperationspartner	Kooperation	Partner
Kooperationsplattform	Kooperation	Plattform
Kooperationsvereinbarung	Kooperation	Vereinbarung
Koordinatorin	Koordinator	in
Kopfhaar	Kopf	Haar
Kopfhörer	Kopf	Hörer
Kopfnuss	Kopf	Nuss
Kopfsalat	Kopf	Salat
Kopfschmerz	Kopf	Schmerz
Kopfstand	Kopf	Stand
Kopftuch	Kopf	Tuch
Kopfverletzung	Kopf	Verletzung
Kopfweh	Kopf
Kopfzeile	Kopf	Zeile
Koreanerin	Koreaner	in
Kornettistin	Kornettist	in
Koronargefäß	koronar	Gefäß
Korrekturleserin	Korrekturleser	in
Korrespondentin	Korrespondent	in
Kosmetikindustrie	Kosmetik	Industrie
Kosmonaut	kosmo	naut
Kosmonautin	Kosmonaut	in
Kosovokrieg	Kosovo	Krieg
Kostümierung	kostümieren	ung
Kraftfahrzeug	Kraft	Fahrzeug
Kraftfahrzeugführer	Kraftfahrzeug	Führer
Kraftfahrzeuginstandsetzung	Kraftfahrzeug	Instandsetzung
Kraftfahrzeugkennzeichen	Kraftfahrzeug	Kennzeichen
Kraftsport	Kraft	Sport
Kraftstoff	Kraft	Stoff
Kraftwagen	Kraft	Wagen
Kraftwerk	Kraft	Werk
Krankenhaus	Kranke	Haus
Krankenhaushygiene	Krankenhaus	Hygiene
Krankenpfleger	Kranke	n	Pfleger
Krankenpflegerin	Krankenpfleger	in
Krankenschwester	Kranke	Schwester
Krankenstand	Kranke	Stand
Krankenstation	Kranke	Station
Krankenversicherungsbeitrag	Krankenversicherung	Beitrag
Krawattenknoten	Krawatte	Knoten
Krawattennadel	Krawatte	Nadel
Krebserkrankung	Krebs	Erkrankung
Krebsleiden	Krebs	Leiden
Kreidezeit	Kreide	Zeit
Kreisausschuss	Kreis	Ausschuss
Kreislauf	Kreis	Lauf
Kreuzer	kreuzen	er
Kriegerin	Krieger	in
Kriegsflüchtling	Krieg	s	Flüchtling
Kriegsherr	Krieg	Herr
Kriegswaise	Krieg	s	Waise
Kriminologin	Kriminologe	in
Krisentreffen	Krise	Treffen
Kristallisationskern	Kristallisation	s	Kern
Kristallnacht	Kristall	Nacht
Kritikerin	Kritiker	in
Kräuterbutter	Kraut	Butter
Krügerin	Krüger	in
Krümelschublade	Krümel	Schublade
Kugelfisch	Kugel	Fisch
Kugelschreiber	Kugel	Schreiber
Kuhdorf	Kuh	Dorf
Kuhherde	Kuh	Herde
Kuhkaff	Kuh	Kaff
Kuhmilch	Kuh	Milch
Kuipergürtel	Kuiper	Gürtel
Kulturdenkmal	Kultur	Denkmal
Kulturerbe	Kultur	Erbe
Kulturgeschichte	Kultur	Geschichte
Kulturingenieurin	Kulturingenieur	in
Kulturphänomen	Kultur	Phänomen
Kultursprache	Kultur	Sprache
Kulturwirtschaft	Kultur	Wirtschaft
Kulturwissenschaft	Kultur	Wissenschaft
Kundenkreis	Kunde	Kreis
Kundin	Kunde	in
Kunstausstellung	Kunst	Ausstellung
Kunstgeschichte	Kunst	Geschichte
Kunsthalle	Kunst	Halle
Kunsthistoriker	Kunst	Historiker
Kunsthistorikerin	Kunsthistoriker	in
Kunsthochschule	Kunst	Hochschule
Kunsthändler	Kunst	Händler
Kunsthändlerin	Kunsthändler	in
Kunstkritikerin	Kunstkritiker	in
Kunstmusik	Kunst	Musik
Kunstsammlung	Kunst	Sammlung
Kunstschule	Kunst	Schule
Kunstsprache	Kunst	Sprache
Kunststoff	Kunst	Stoff
Kunststoffbahn	Kunststoff	Bahn
Kunststofffenster	Kunststoff	Fenster
Kunststofffolie	Kunststoff	Folie
Kunststoffgranulat	Kunststoff	Granulat
Kunststoffindustrie	Kunststoff	Industrie
Kunststoffrecycling	Kunststoff	Recycling
Kunststoffrohr	Kunststoff	Rohr
Kunststofftechnik	Kunststoff	Technik
Kunststoffverpackung	Kunststoff	Verpackung
Kunststudent	Kunst	Student
Kunstverein	Kunst	Verein
Kunstzeitschrift	Kunst	Zeitschrift
Kunstzentrum	Kunst	Zentrum
Kupferlegierung	Kupfer	Legierung
Kupfermünze	Kupfer	Münze
Kuratorin	Kurator	in
Kurbelwelle	Kurbel	Welle
Kurzfilm	kurz	Film
Kurzware	kurz	Ware
Kuwaiter	Kuwait	er
Kuwaiterin	Kuwaiter	in
Käferart	Käfer	Art
Käffchen	Kaffee	chen
Kälbchen	Kalb	chen
Kämmerchen	Kammer	chen
Kämpferin	Kämpfer	in
Käseblatt	Käse	Blatt
Käsekuchen	Käse	Kuchen
Käserinde	Käse	Rinde
Käsesandwich	Käse	Sandwich
Kätzchen	Katze	chen
Käuferin	Käufer	in
Käuzchen	Kauz	chen
Köhlerin	Köhler	in
Königin	König	in
Königreich	König	Reich
Königsallee	König	Allee
Königsberg	König	Berg
Königshof	König	Hof
Königskerze	König	Kerze
Königslilie	König	Lilie
Königsnuss	König	Nuss
Körpersprache	Körper	Sprache
Körperteil	Körper	Teil
Küchenabfall	Küche	Abfall
Küchengarten	Küche	Garten
Küchenhandtuch	Küche	Handtuch
Küchenmaschine	Küche	Maschine
Küchenmesser	Küche	Messer
Küchensieb	Küche	Sieb
Küchentuch	Küche	Tuch
Küchenuhr	Küche	Uhr
Küchenwaage	Küche	Waage
Küchlein	Küche	Kuchen	-lein
Kühlerhaube	Kühler	Haube
Künstlerin	Künstler	in
Künstlerroman	Künstler	Roman
Kürschnerin	Kürschner	in
LAN-Party	LAN	Party
Laborexperiment	Labor	Experiment
Laborgerät	Labor	Gerät
Laborkittel	Labor	Kittel
Labormaus	Labor	Maus
Laborschule	Labor	Schule
Laborunfall	Labor	Unfall
Lackierer	lackieren	er
Ladendieb	Laden	Dieb
Laderaum	Lade	Raum
Ladungstrennung	Ladung	Trennung
Lagerstätte	Lager	Stätte
Laienarbeit	Laie	Arbeit
Landfahrzeug	Land	Fahrzeug
Landhaus	Land	Haus
Landkarte	Land	Karte
Landkrieg	Land	Krieg
Landschaft	Land	schaft
Landschaftsarchitekt	Landschaft	Architekt
Landschaftsmalerin	Landschaftsmaler	in
Landschaftsökologie	Landschaft	s	Ökologie
Landwirtin	Landwirt	in
Landwirtschaft	Land	Wirtschaft
Landwirtschaftsminister	Landwirtschaft	Minister
Landwirtschaftswissenschaft	Landwirtschaft	Wissenschaft
Langspielplatte	lange	spielen	Platte
Lastkraftwagen	Last	Kraftwagen
Laubbaum	Laub	Baum
Laubhütte	Laub	Hütte
Laubhüttenfest	Laubhütte	Fest
Laufbahn	Lauf	Bahn
Laugenbrezel	Lauge	Brezel
Laugenbrötchen	Lauge	Brötchen
Laugengebäck	Lauge	Gebäck
Laugenhörnchen	Lauge	Hörnchen
Laugensemmel	Lauge	Semmel
Laugenstange	Lauge	Stange
Lautmalerei	Laut	Malerei
Lavendelöl	Lavendel	Öl
Lawinenkegel	Lawine	Kegel
Lebensabschnitt	Leben	Abschnitt
Lebensabschnittsgefährte	Lebensabschnitt	Gefährte
Lebensabschnittsgefährtin	Lebensabschnitt	Gefährtin
Lebensenergie	Leben	Energie
Lebensmittel	Leben	Mittel
Lebensmittelanalytik	Lebensmittel	Analytik
Lebenspartnerschaft	Leben	Partnerschaft
Lebenspunkt	Leben	s	Punkt
Lebensqualität	Leben	Qualität
Lebensraum	Leben	Raum
Lebensversicherungsgesellschaft	Lebensversicherung	Gesellschaft
Lebensversicherungsunternehmen	Lebensversicherung	Unternehmen
Lebenszyklus	Leben	Zyklus
Leberknödel	Leber	Knödel
Leberknödelsuppe	Leberknödel	Suppe
Leberwurst	Leber	Wurst
Lederhaut	Leder	Haut
Lederjacke	Leder	Jacke
Leergutautomat	Leergut	Automat
Leerraum	leer	Raum
Legionsadler	Legion	Adler
Lehnwort	Lehn	Wort
Lehrerin	Lehrer	in
Leichenbegräbnis	Leiche	Begräbnis
Leichenverbrennung	Leiche	Verbrennung
Leichtathletikmeisterschaft	Leichtathletik	Meisterschaft
Leierschwanz	Leier	Schwanz
Leimfarbe	Leim	Farbe
Leinengarn	Leinen	Garn
Leinengewebe	Leinen	Gewebe
Leinenstoff	Leinen	Stoff
Leinentuch	Leinen	Tuch
Leinenweber	Leinen	Weber
Leinenweberin	Leinenweber	in
Leineweberin	Leineweber	in
Leinweberin	Leinweber	in
Leinöl	Lein	Öl
Leistungslohn	Leistung	Lohn
Leistungssteigerung	Leistung	Steigerung
Leistungsumsatz	Leistung	s	Umsatz
Leiterin	Leiter	in
Leitwort	leiten	Wort
Leitwortstil	Leitwort	Stil
Lektorin	Lektor	in
Lenker	lenken	er
Lenkerbreite	Lenker	Breite
Lenkrad	lenken	Rad
Leopardenohr	Leopard	Ohr
Lesbenbewegung	Lesbe	Bewegung
Lesbierin	Lesbier	in
Leser	lesen	er
Leserei	lesen	erei
Leserin	Leser	in
Leuchtturmmuseum	Leuchtturm	Museum
Leuchtturmwärterin	Leuchtturmwärter	in
Lexikograf	lexiko
Lexikografie	lexiko
Lexikografin	Lexikograf	in
Lexikograph	lexiko	graf
Lexikographie	lexiko
Lexikographin	Lexikograph	in
Lexikologe	lexiko
Lexikologie	lexiko
Lexikologin	Lexikologe	in
Lexikostatistik	lexiko
Libanesin	Libanese	in
Librettistin	Librettist	in
Libyerin	Libyer	in
Lichtabsorption	Licht	Absorption
Lichtgeschwindigkeit	Licht	Geschwindigkeit
Lichthupe	Licht	Hupe
Lichtkegel	Licht	Kegel
Lichtquelle	Licht	Quelle
Lichtsignalanlage	Lichtsignal	Anlage
Lichtspielhaus	Lichtspiel	Haus
Liebesabenteuer	Liebe	Abenteuer
Liebesaffäre	Liebe	Affäre
Liebesakt	Liebe	Akt
Liebesapfel	Liebe	Apfel
Liebesband	Liebe	Band
Liebesbedürfnis	Liebe	Bedürfnis
Liebesbekundung	Liebe	Bekundung
Liebesbeteuerung	Liebe	Beteuerung
Liebesbeweis	Liebe	Beweis
Liebesbeziehung	Liebe	Beziehung
Liebesblick	Liebe	Blick
Liebesbote	Liebe	Bote
Liebesbotschaft	Liebe	Botschaft
Liebesbrand	Liebe	Brand
Liebesbrief	Liebe	Brief
Liebesbrunst	Liebe	Brunst
Liebeserklärung	Liebe	Erklärung
Liebeserlebnis	Liebe	Erlebnis
Liebesgott	Liebe	Gott
Liebesgöttin	Liebesgott	in
Liebesintrige	Liebe	Intrige
Liebesknochen	Liebe	Knochen
Liebeskummer	Liebe	Kummer
Liebesleben	Liebe	Leben
Liebesleid	Liebe	Leid
Liebeslied	Liebe	Lied
Liebeslyrik	Liebe	Lyrik
Liebesperle	Liebe	Perle
Liebeszauber	Liebe	Zauber
Liebhaberin	Liebhaber	in
Lieblingin	Liebling	in
Lieblingsessen	Liebling	s	Essen
Lieblingsfilm	lieblings	Film
Lieblingsfrau	Liebling	Frau
Lieblingskomponistin	Lieblingskomponist	in
Liechtensteiner	Liechtenstein	er
Liechtensteinerin	Liechtensteiner	in
Liederbuch	Lied	Buch
Lieferantin	Lieferant	in
Limettensaft	Limette	Saft
Linguistin	Linguist	in
Linkshänderin	Linkshänder	in
Linsengericht	Linse	Gericht
Lipidmembran	Lipid	Membran
Lippenstift	Lippe	Stift
Litauerin	Litauer	in
Literaturhistoriker	Literatur	Historiker
Literaturhistorikerin	Literaturhistoriker	in
Literaturkritikerin	Literaturkritiker	in
Literaturpreis	Literatur	Preis
Literatursprache	Literatur	Sprache
Literaturverzeichnis	Verzeichniß	Verzeichnis	Literatur
Literaturwissenschaft	Literatur	Wissenschaft
Literaturwissenschaftlerin	Literaturwissenschaftler	in
Lithografin	Lithograf	in
Lithographin	Lithograph	in
Livemusik	live	Musik
Lobbyistin	Lobbyist	in
Locher	lochen	er
Logistikerin	Logistiker	in
Lohnkosten	Lohn	Kosten
Lokomotivführerin	Lokomotivführer	in
Lombretisch	Lombre	Tisch
Luftangriff	Luft	Angriff
Luftballon	Luft	Ballon
Luftfahrt	Luft	Fahrt
Luftfahrtunternehmen	Luftfahrt	Unternehmen
Luftfahrzeug	Luft	Fahrzeug
Luftfeuchtigkeit	Luft	Feuchtigkeit
Luftfilter	Luft	Filter
Luftklappe	Luft	Klappe
Luftmasche	Luft	Masche
Luftpolsterumschlag	Luft	Polster	Umschlag
Luftpumpe	Luft	Pumpe
Luftqualität	Luft	Qualität
Luftröhre	Luft	Röhre
Luftsack	Luft	Sack
Luftschicht	Luft	Schicht
Luftsport	Luft	Sport
Luftverschmutzung	Luft	Verschmutzung
Luftwaffe	Luft	Waffe
Lumpenhaufen	Lumpen	Haufen
Lumpenhändler	Lumpen	Händler
Lumpenkiste	Lumpen	Kiste
Lumpenmann	Lumpen	Mann
Lumpenproletarier	Lumpen	Proletarier
Lumpensack	Lumpen	Sack
Lumpensammler	Lumpen	Sammler
Lustschloss	Schloss
Luxemburger	Luxemburg	er
Luxemburgerin	Luxemburger	in
Lyrikerin	Lyriker	in
Läuferin	Läufer	in
Löffelchen	Löffel	chen
Löslichkeitsprodukt	Löslichkeit	Produkt
Lötrauchabsaugung	Lötrauch	Absaugung
Löwenohr	Löwe	Ohr
Löwenwelpe	Löwe	Welpe
Löwenzahn	Löwe	Zahn
Lüftungsanlage	Lüftung	Anlage
Lügengebäude	Lüge	Gebäude
Machung	machen	ung
Magensaft	Magen	Saft
Magiepunkt	Magie	Punkt
Mahlgrad	mahlen	Grad
Mahlzeit	Mahl	Zeit
Maikraut	Mai	Kraut
Mailadresse	Mail	Adresse
Mailserver	Mail	Server
Mailänderin	Mailänder	in
Mainzer	Mainz	er
Maissaat	Mais	Saat
Maitag	Mai	Tag
Maklerin	Makler	in
Malerbetrieb	Maler	Betrieb
Malerin	Maler	in
Malteserin	Malteser	in
Mammutaufgabe	Mammut	Aufgabe
Managerin	Manager	in
Mandelhörnchen	Mandel	Hörnchen
Mandelkern	Mandel	Kern
Mandelmühle	Mandel	Mühle
Mandelöl	Mandel	Öl
Mannigfaltigkeit	mannigfaltig	keit
Mannschaft	Mann	schaft
Manuskripthalter	Manuskript	Halter
Manövergebiet	Manöver	Gebiet
Maracujasaft	Maracuja	Saft
Marathonläuferin	Marathonläufer	in
Marineoffizier	Marine	Offizier
Marineoffizierin	Marineoffizier	in
Markenerzeugnis	Marke	Erzeugnis
Marktschirm	Markt	Schirm
Markttag	Markt	Tag
Marktteilnehmer	Markt	Teilnehmer
Marmelstein	Marmel	Stein
Marmorkuchen	Marmor	Kuchen
Marsbewohner	Mars	Bewohner
Marsbewohnerin	Marsbewohner	in
Marschkapelle	Marsch	Kapelle
Marsianer	Mensch	Mars
Marsmensch	Mars	Mensch
Marzipankartoffel	Marzipan	Kartoffel
Maschinenbauingenieurin	Maschinenbauingenieur	in
Maschinenraum	Maschine	Raum
Maschinensprache	Maschine	Sprache
Maskenbildnerin	Maskenbildner	in
Maskenpflicht	Maske	Pflicht
Massageöl	Massage	Öl
Massendemonstration	Masse	Demonstration
Massenexekution	massen	Exekution
Massenkarambolage	Masse	n	Karambolage
Massenmord	massen	Mord
Massenphänomen	Masse	Phänomen
Massenprotest	Masse	Protest
Massenüberwachung	Masse	Überwachung
Materialmangel	Material	Mangel
Materialwissenschaft	Material	Wissenschaft
Mathematikdidaktik	Mathematik	Didaktik
Mathematikerin	Mathematiker	in
Maulheld	Maul	Held
Maultrommel	Maul	Trommel
Maurerin	Maurer	in
Maurermeister	Maurer	Meister
Maßstab	Maß	Stab
Mechanikerin	Mechaniker	in
Medaillengewinnerin	Medaillengewinner	in
Medizinball	Medizin	Ball
Medizinerin	Mediziner	in
Medizinstudentin	Medizinstudent	in
Meereis	Meer	Eis
Meeresspiegelanstieg	-s	Meeresspiegel	Anstieg
Meerwasserentsalzungsanlage	Meerwasser	Entsalzungsanlage
Mehlmotte	Mehl	Motte
Mehrfachsteckdose	mehrfach	Steckdose
Mehrweg	mehr	Weg
Mehrwegpfand	Mehrweg	Pfand
Meinungsfreiheit	Meinung	Freiheit
Meisterschaft	Meister	schaft
Meisterwerk	Meister	Werk
Menorquinerin	Menorquiner	in
Menschenrecht	Mensch	Recht
Menschenwerk	Mensch	Werk
Menschheit	Mensch	heit
Menstruationsproblem	Menstruation	Problem
Menüpunkt	Menü	Punkt
Merkspruch	merken	Spruch
Metallindustrie	Metall	Industrie
Metallogin	Metalloge	in
Metallschmied	Metall
Metaphysikerin	Metaphysiker	in
Meteorologin	Meteorologe	in
Meterband	Meter	Band
Metermaß	Maß
Metzgergang	Metzger	Gang
Metzgerin	Metzger	in
Mexikanerin	Mexikaner	in
Mieterin	Mieter	in
Mietshaus	Miete	Haus
Migrantin	Migrant	in
Mikrobiologin	Mikrobiologe	in
Mikroebene	mikro	Ebene
Mikropille	mikro	Pille
Milchdrüse	Milch	Drüse
Milcheis	Milch	Eis
Milchfett	Milch	Fett
Milchgebiss	Milch	Gebiss
Milchkanne	Milch	Kanne
Milchkuh	Milch	Kuh
Milchmädchen	Milch	Mädchen
Milchmädchenrechnung	Milchmädchen	Rechnung
Milchprodukt	Milch	Produkt
Milchpulver	Milch	Pulver
Milchpumpe	Milch	Pumpe
Milchreis	Milch	Reis
Milchstraße	Straße	Milch	Strasse
Milchsäure	Milch	Säure
Milchzucker	Milch	Zucker
Milchzuckerunverträglichkeit	Milchzucker	Unverträglichkeit
Militäreskorte	Militär	Eskorte
Militärfahrzeug	Militär	Fahrzeug
Militärgeschichte	Militär	Geschichte
Militärwissenschaft	Militär	Wissenschaft
Milligon	milli	Gon
Millionenstadt	Million	Stadt
Mindestlohn	mindest	Lohn
Mineralogin	Mineraloge	in
Mineralwasser	Mineral	Wasser
Mineralöl	Mineral	Öl
Ministerin	Minister	in
Ministerpräsidentenkonferenz	Ministerpräsident	Konferenz
Minuskelziffer	Minuskel	Ziffer
Minütchen	Minute	chen
Missionarin	Missionar	in
Mistgabel	Mist	Gabel
Mistkerl	Mist	Kerl
Mistkäfer	Mist	Käfer
Mitarbeiter	mit	Arbeiter
Mitbewohnerin	Mitbewohner	in
Mitlaut	mit	Laut
Mitstreiterin	Mitstreiter	in
Mittelachse	mittel
Mittelalter	mittel
Mittelamerika	mittel
Mittelarmlehne	mittel
Mittelbau	mittel
Mittelbauer	mittel
Mittelbehörde	mittel
Mittelblock	mittel
Mitteldeutsch	mittel
Mitteldeutsche	mittel
Mitteldeutschland	mittel
Mittelding	mittel
Mitteldorf	mittel
Mitteldrittel	mittel
Mitteleuropa	mittel
Mittelfeld	mittel
Mittelfenster	mittel
Mittelfinger	mittel	Finger
Mittelfront	mittel
Mittelfuß	mittel
Mittelgang	mittel
Mittelgebirge	mittel
Mittelgewicht	mittel
Mittelglied	mittel
Mittelgrund	mittel
Mittelhand	mittel
Mittelhirn	mittel
Mittelhochdeutsch	mittel
Mittelhochdeutsche	mittel
Mittelinsel	mittel
Mittelinstanz	mittel
Mittelkajüte	mittel
Mittelklasse	mittel
Mittelklassefahrzeug	Mittelklasse	Fahrzeug
Mittelkonsole	mittel
Mittelkreis	mittel
Mittelkurs	mittel	Kurs
Mittellage	mittel
Mittellatein	mittel
Mittellauf	mittel
Mittelleitplanke	mittel
Mittellinie	mittel
Mittellot	mittel
Mittelläufer	mittel
Mittelmacht	mittel
Mittelmast	mittel
Mittelmoräne	mittel
Mittelmotor	mittel
Mittelniederdeutsch	mittel
Mittelohr	mittel
Mittelpfeiler	mittel
Mittelpromenade	mittel
Mittelpunkt	mittel
Mittelreihe	mittel
Mittelsatz	mittel
Mittelscheitel	mittel
Mittelschicht	mittel
Mittelschiff	mittel
Mittelschmerz	mittel
Mittelschule	mittel
Mittelschwergewicht	mittel
Mittelschüler	mittel	Schüler
Mittelspur	mittel
Mittelstaat	mittel
Mittelstand	mittel
Mittelstation	mittel
Mittelsteinzeit	mittel
Mittelstellung	mittel
Mittelstimme	mittel
Mittelstrecke	mittel
Mittelstreifen	mittel
Mittelstufe	mittel
Mittelstück	mittel
Mittelstürmer	mittel
Mittelteil	mittel
Mitteltemperatur	mittel
Mitteltisch	mittel
Mitteltrakt	mittel
Mitteltöner	mittel
Mitteltür	mittel
Mittelweg	mittel
Mittelwelle	mittel
Mittelöl	mittel
Mittwochabend	Mittwoch	Abend
Mittwochmittag	Mittwoch	Mittag
Mittwochmorgen	Mittwoch	Morgen
Mittwochnachmittag	Mittwoch	Nachmittag
Mittwochnacht	Mittwoch	Nacht
Mittwochvormittag	Mittwoch	Vormittag
Modeartikel	Mode	Artikel
Modedesignerin	Modedesigner	in
Moderatorin	Moderator	in
Mohnkuchen	Mohn	Kuchen
Mohnstrudel	Mohn	Strudel
Moldauerin	Moldauer	in
Monarchist	Monarchie	ist
Monatslohn	Monat	Lohn
Monatsschrift	Monat	s	Schrift
Mondanziehung	Mond
Mondanzug	Mond
Mondaufgang	Mond
Mondauto	Mond
Mondbahn	Mond
Mondbein	Mond
Mondbogen	Mond	Bogen
Mondboot	Mond
Mondesdämmer	Mond
Mondesglanz	Mond
Mondfahrer	Mond
Mondfinsternis	Mond	Finsternis
Mondfisch	Mond
Mondfleck	Mond
Mondflug	Mond
Mondfähre	Mond
Mondgebirge	Mond
Mondgesicht	Mond
Mondgestein	Mond
Mondgravitation	Mond
Mondkalender	Mond
Mondknoten	Mond
Mondkrater	Mond	Krater
Mondlandschaft	Mond	Landschaft
Mondlandung	Mond	Landung
Mondlauf	Mond
Mondlicht	Mond	Licht
Mondnacht	Mond
Mondoberfläche	Mond
Mondphase	Mond	Phase
Mondpreis	Mond
Mondregenbogen	Mond	Regenbogen
Mondrinde	Mond
Mondscheibe	Mond
Mondschein	Mond	Schein
Mondschiff	Mond
Mondsichel	Mond
Mondsonde	Mond
Mondstaub	Mond
Mondsucht	Mond
Mondumkreisung	Mond
Monduntergang	Mond
Mondwechsel	Mond
Mongolin	Mongole	in
Monostoffstrom	mono	Stoff	Strom
Montagehalle	Montage	Halle
Montagmittag	Montag	Mittag
Montagnachmittag	Montag	Nachmittag
Montagvormittag	Montag	Vormittag
Montenegrinerin	Montenegriner	in
Moorfrosch	Moor	Frosch
Morgenfrühe	Morgen	Frühe
Morgenhimmel	Morgen	Himmel
Morgenkaffee	Morgen	Kaffee
Morgenlicht	Morgen	Licht
Morgensonne	Morgen	Sonne
Morgenstern	Morgen	Stern
Morgenzeitung	Morgen	Zeitung
Morphologin	Morphologe	in
Motorradunfall	Motorrad	Unfall
Multiplikationstafel	Multiplikation	Tafel
Mund-Nasen-Bedeckung	Mund	Nase	Bedeckung
Mund-Nasen-Schutz	Mund	Nase	Schutz
Mund-zu-Mund-Beatmung	zu	Mund	Beatmung
Mundart	Mund
Mundatmung	Mund	Atmung
Mundbakterie	Bakterie
Mundbeatmung	Mund	Beatmung
Munddusche	Mund	Dusche
Mundharmonika	Mund	Harmonika
Mundhöhle	Mund	Höhle
Mundorgel	Mund	Orgel
Mundtrommel	Mund	Trommel
Mundwinkel	Mund	Winkel
Munitionslager	Munition	Lager
Murmeltier	Murmel	Tier
Musentempel	Muse	Tempel
Musikakademie	Musik	Akademie
Musikarchiv	Musik	Archiv
Musikaufführung	Musik	Aufführung
Musikbibliothek	Musik	Bibliothek
Musikerin	Musiker	in
Musikfestival	Musik	Festival
Musikgeschäft	Musik	Geschäft
Musikgruppe	Musik	Gruppe
Musikhochschule	Musik	Hochschule
Musikindustrie	Musik	Industrie
Musikinstrument	Musik	Instrument
Musikkassette	Musik	Kassette
Musiklabel	Musik	Label
Musiklexikon	Musik	Lexikon
Musikliteratur	Musik	Literatur
Musikpreis	Musik	Preis
Musikproduktion	Musik	Produktion
Musikproduzent	Musik	Produzent
Musikproduzentin	Musikproduzent	in
Musikprofessor	Musik	Professor
Musikprogramm	Musik	Programm
Musikpädagoge	Musik	Pädagoge
Musikrat	Musik	Rat
Musikraum	Musik	Raum
Musiksaal	Musik	Saal
Musikschule	Musik	Schule
Musiksendung	Musik	Sendung
Musiksoziologie	Musik	Soziologie
Musikszene	Musik	Szene
Musiktheorie	Musik	Theorie
Musiktradition	Musik	Tradition
Musikunterricht	Musik	Unterricht
Musikverein	Musik	Verein
Musikverleger	Musik	Verleger
Musikvideo	Musik	Video
Musikwerk	Musik	Werk
Musikwettbewerb	Musik	Wettbewerb
Musikwissenschaft	Musik	Wissenschaft
Musikwissenschaftlerin	Musikwissenschaftler	in
Musikzimmer	Musik	Zimmer
Musikästhetik	Musik	Ästhetik
Muskelfaser	Muskel	Faser
Muskelreflex	Muskel	Reflex
Mutterbruder	Mutter	Bruder
Mutterkuchen	Mutter	Kuchen
Muttermal	Mutter	Mal
Muttermilch	Mutter	Milch
Mutterschwester	Mutter	Schwester
Muttersprache	Mutter	Sprache
Muttersprachlerin	Muttersprachler	in
Muttertag	Mutter	Tag
Myanmarin	Myanmare	in
Männerdutt	Mann	Dutt
Männin	Mann	in
Märzglöckchen	März	Glöckchen
Märztag	März	Tag
Mäusebussard	Maus	Bussard
Mäuseohr	Maus	Ohr
Möbelindustrie	Möbel	Industrie
Möchtegern	gern	mögen
Möndchen	Mond
Mörderin	Mörder	in
Mühlenrad	Mühle	Rad
Mühlrad	Mühle	Rad
Mühmchen	Muhme	chen
Müllabfuhr	Müll	Abfuhr
Mülleimer	Müll	Eimer
Müllerin	Müller	in
Müllfahrzeug	Müll	Fahrzeug
Mülltonne	Müll	Tonne
Müllverbrennungsanlage	Müllverbrennung	Anlage
Münzfernsprecher	Münze	Fernsprecher
Münztelefon	Münze	Telefon
Nachbargemeinde	Nachbar	Gemeinde
Nachbarin	Nachbar	in
Nachbarland	Nachbar	Land
Nachfolgekandidat	Nachfolge	Kandidat
Nachhaltigkeit	nachhaltig	keit
Nachhaltigkeitspolitik	Nachhaltigkeit	Politik
Nachhaltigkeitsrücklage	Nachhaltigkeit	Rücklage
Nachhilfelehrerin	Nachhilfelehrer	in
Nachmittag	nach	Mittag
Nachtarbeit	Nacht	Arbeit
Nachtfalter	Nacht	Falter
Nachtflug	Nacht	Flug
Nachtklub	Nacht	Klub
Nachtmahr	Nacht	Mahr
Nachtmusik	Nacht	Musik
Nachtruhe	Nacht	Ruhe
Nachtschwärmerin	Nachtschwärmer	in
Nachttisch	Nacht	Tisch
Nachtvogel	Nacht	Vogel
Nachzüglerin	Nachzügler	in
Nacktaufnahme	nackt	Aufnahme
Nacktbadestrand	baden	nackt	Strand	Badestrand
Nacktschnecke	nackt	Schnecke
Nackttänzerin	Nackttänzer	in
Nadelöhr	Nadel	Öhr
Nagelbett	Nagel	Bett
Nagelbürste	Nagel	Bürste
Nagelfeile	Nagel	Feile
Nagellack	Nagel	Lack
Nagellackentferner	Nagellack	Entferner
Nagelschere	Nagel	Schere
Nahost	nahe	Ost
Nahostkonflikt	Nahost	Konflikt
Nahrungsaufnahme	Nahrung	Aufnahme
Nahrungskette	Nahrung	Kette
Nahrungsmittel	Nahrung	Mittel
Namensdeutung	Name	Deutung
Namenwort	Name	Wort
Namibierin	Namibier	in
Napfkuchen	Napf	Kuchen
Narkosearzt	Narkose	Arzt
Narkoseärztin	Narkosearzt	in
Narratorin	Narrator	in
Nasallaut	Nasal	Laut
Nasenbein	Nase	Bein
Nasenbeinbruch	Nasenbein	Bruch
Nasenfahrrad	Nase	Fahrrad
Nasenhöhle	Nase	Höhle
Nasenlaut	Nase	Laut
Nasenloch	Nase	Loch
Nasennebenhöhle	Nase	Nebenhöhle
Nasenpiercing	Nase	Piercing
Nasenring	Nase	Ring
Nassauerin	Nassauer	in
Nationalbank	national	Bank
Nationalistin	Nationalist	in
Nationalsozialistin	Nationalsozialist	in
Nationalsport	national	Sport
Nationaltrainerin	Nationaltrainer	in
Naturereignis	Natur	Ereignis
Naturerscheinung	Natur	Erscheinung
Naturkatastrophe	Natur	Katastrophe
Naturphänomen	Natur	Phänomen
Naturschützerin	Naturschützer	in
Natursekt	Natur	Sekt
Naturwissenschaft	Natur	Wissenschaft
Naturwissenschaftlerin	Naturwissenschaftler	in
Nauruerin	Nauruer	in
Neandertaler	Neandertal	Neanderthal	-er
Nebelkerze	Nebel	Kerze
Nebelmonat	Nebel	Monat
Nebelscheinwerfer	Nebel	Scheinwerfer
Nebenhandlung	neben	Handlung
Nebenschilddrüsenhormon	Nebenschilddrüse	Hormon
Neogen	neo	gen
Neopronomen	neo	Pronomen
Nepaler	Nepal	er
Nepalerin	Nepaler	in
Nepalesin	Nepalese	in
Nervensystem	Nerv	System
Nettolohn	netto	Lohn
Netzhaut	Netz	Haut
Netzwerk	Netz	werk
Neubaustrecke	Neubau	Strecke
Neuerfindung	neu	Erfindung
Neujahr	neu	Jahr
Neurologin	Neurologe	in
Neuropsychologin	Neuropsychologe	in
Neuseeländer	Neuseeland	er
Neuseeländerin	Neuseeländer	in
Neutronenstern	Neutron	en	Stern
Neutronenstreuung	Neutron	Streuung
Nichtmuttersprachlerin	Nichtmuttersprachler	in
Nichtraucherin	Nichtraucher	in
Nichtvorhandensein	nicht	Vorhandensein
Niederländerin	Niederländer	in
Nierenschale	Niere	Schale
Nigerianerin	Nigerianer	in
Nobelpreisträgerin	Nobelpreisträger	in
Nordeingang	Norden	Eingang
Nordengland	Nord	England
Nordkoreaner	Nordkorea	er
Nordkoreanerin	Nordkoreaner	in
Nordlicht	Norden	Licht
Nordmazedonierin	Nordmazedonier	in
Nordsee	Nord	See
Nordseeheilbad	Nordsee	Heilbad
Norwegerin	Norweger	in
Notarzt	Not	Arzt
Notaufnahme	Not	Aufnahme
Notdürftigkeit	notdürftig	keit
Notenpult	Note	Pult
Notenständer	Note	Ständer
Notfall	Not	Fall
Notizbuch	Notiz	Buch
Notwendigkeit	notwendig	keit
Novembertag	November	Tag
Nudelholz	Nudel	Holz
Nudelsalat	Nudel	Salat
Nudelsuppe	Nudel	Suppe
Nukleinsäure	Nuklein	Säure
Numismatikerin	Numismatiker	in
Nussbutter	Nuss	Butter
Nussecke	Nuss	Ecke
Nussschale	Nuss	Schale
Nähnadel	nähen	Nadel
Nährmutter	nähren	Mutter
Oberbürgermeisterin	Oberbürgermeister	in
Oberschülerin	Oberschüler	in
Oberwelt	ober	Welt
Objektbeschreibung	Objekt	Beschreibung
Obmännin	Obmann	in
Oboerin	Oboer	in
Oboistin	Oboist	in
Obstbanane	Obst	Banane
Obstbaumwiese	Obstbaum	Wiese
Obstgarten	Obst	Garten
Obstkuchen	Obst	Kuchen
Obstpresse	Obst	Presse
Obstsaft	Obst	Saft
Obstsalat	Obst	Salat
Obstschale	Obst	Schale
Offizierin	Offizier	in
Ohrenschmalz	Ohr	Schmalz
Ohrfeige	Ohr	Feige
Ohrring	Ohr	Ring
Ohrspeicheldrüse	Ohr	Speicheldrüse
Ohrspeicheldrüsenentzündung	Ohrspeicheldrüse	Entzündung
Ohrwurm	Ohr	Wurm
Oktobertag	Oktober	Tag
Oligozän	oligo	zän
Omanerin	Omaner	in
Omi	Oma	i
Onkologin	Onkologe	in
Open-Air-Festival	Open Air	Festival
Opernsängerin	Opernsänger	in
Opiumraucherin	Opiumraucher	in
Optikerin	Optiker	in
Orangenbaum	Orange	Baum
Orangenlimonade	Orange	Limonade
Orangenmarmelade	Orange	Marmelade
Orangensaft	Orange	Saft
Orangenschale	Orange	Schale
Orchesterinstrument	Orchester	Instrument
Ordnungshüter	Ordnung	Hüter
Organisationsebene	Organisation	Ebene
Organisatorin	Organisator	in
Organistin	Organist	in
Organspender	Organ	Spender
Orgelbauerin	Orgelbauer	in
Orgelmusik	Orgel	Musik
Ornithologin	Ornithologe	in
Ortsgruppe	Ort	Gruppe
Ortsname	Ort	Name
Ortsteil	Ort	Teil
Ortsvorsteherin	Ortsvorsteher	in
Ortszeit	Ort	Zeit
Ostdeutschland	Ost	Deutschland
Osteopathin	Osteopath	in
Osterferien	Ostern	Ferien
Ostermond	Ostern	Mond
Osteuropäerin	Osteuropäer	in
Ostsee	Ost	See
Ostseeküste	Ostsee	Küste
Ozonschicht	Ozon	Schicht
Paartanz	Paar	Tanz
Paketpostamt	Paket	Postamt
Pakistanerin	Pakistaner	in
Paläontologin	Paläontologe	in
Palästinenserführer	Palästinenser	Führer
Pandabär	Panda	Bär
Panoramafreiheit	Panorama	Freiheit
Panzerkampfwagen	Panzer	Kampfwagen
Panzerzug	Panzer	Zug
Papierblume	Papier	Blume
Papierbogen	Papier	Bogen
Papierdrachen	Papier	Drachen
Papierflieger	Papier	Flieger
Papierhandtuch	Papier	Handtuch
Papiermangel	Papier
Papierrecycling	Papier	Recycling
Papierschere	Papier	Schere
Papierschlange	Papier	Schlange
Papierserviette	Papier	Serviette
Papiertaschentuch	Papier	Taschentuch
Papiertiger	Papier	Tiger
Papiertonne	Papier	Tonne
Papiertuch	Papier	Tuch
Papiertüte	Papier	Tüte
Pappelallee	Pappel	Allee
Papstname	Papst	Name
Papua-Neuguineer	Papua-Neuguinea	er
Papua-Neuguineerin	Papua-Neuguineer	in
Paradiesapfel	Paradies	Apfel
Paraguayer	Paraguay	er
Paraguayerin	Paraguayer	in
Parkausweis	parken	Ausweis
Parkraumbewirtschaftung	Parkraum	Bewirtschaftung
Parlamentsgebäude	Parlament	Gebäude
Parteiprogramm	Partei	Programm
Partnerin	Partner	in
Partyraucherin	Partyraucher	in
Passagierin	Passagier	in
Passagierliste	Passagier	Liste
Passagierschiff	Passagier	Schiff
Passagierverkehr	Passagier	Verkehr
Passantin	Passant	in
Passwort	Pass	Wort
Pasta	Pasta
Pastorin	Pastor	in
Pathologin	Pathologe	in
Patientin	Patient	in
Pausenclown	Pause	Clown
Pegelhöhe	Pegel	Höhe
Pendeltür	pendeln	Tür
Pendlerpauschale	Pendler
Perkussionistin	Perkussionist	in
Perkussionsinstrument	Perkussion	Instrument
Perlmutterfalter	Perlmutter	Falter
Personalfrage	Personal	Frage
Personendatum	Person	Datum
Persönlichkeit	persönlich	keit
Persönlichkeitsbild	Persönlichkeit	Bild
Persönlichkeitseigenschaft	Persönlichkeit	Eigenschaft
Pfandautomat	Pfand	Automat
Pfandflasche	Pfand	Flasche
Pfannkuchen	Pfanne	Kuchen
Pfarrerin	Pfarrer	in
Pfarrhaus	Pfarre	Haus
Pfarrhof	Pfarre	Hof
Pfefferkorn	Pfeffer	Korn
Pfefferkuchen	Pfeffer	Kuchen
Pfefferminze	Pfeffer	Minze
Pfefferminzöl	Pfefferminze	Öl
Pfeffermühle	Pfeffer	Mühle
Pfefferstreuer	Pfeffer
Pfeifenraucherin	Pfeifenraucher	in
Pfeiferin	Pfeifer	in
Pferdchen	Pferd	chen
Pferdemetzger	Pferd	e	Metzger
Pferdeohr	Pferd	Ohr
Pferderasse	Pferd	Rasse
Pferdeschwanz	Pferd	Schwanz
Pferdeschweif	Pferd	Schweif
Pferdeschwemme	Pferd	Schwemme
Pferdestall	Pferd	Stall
Pflanzengesellschaft	Pflanze	Gesellschaft
Pflanzenmilch	Pflanze	Milch
Pflanzenöl	Pflanze	Öl
Pflegefachkraft	Pflege	Fachkraft
Pflegeheimbewohnerin	Pflegeheimbewohner	in
Pflegeperson	Pflege	Person
Pflegerin	Pfleger	in
Pflichtleistung	Pflicht	Leistung
Pharmakologin	Pharmakologe	in
Phasergewehr	Phaser	Gewehr
Philippinerin	Philippiner	in
Philologin	Philologe	in
Philosophin	Philosoph	in
Phonetikerin	Phonetiker	in
Phonologin	Phonologe	in
Photonentorpedo	Photon	en	Torpedo
Physikerin	Physiker	in
Physiklehrer	Physik	Lehrer
Physiologin	Physiologe	in
Pianistin	Pianist	in
Piepmatz	Piep	Matz
Pilotin	Pilot	in
Pilzsuppe	Pilz	Suppe
Pinkelbecken	pinkeln	Becken
Pinnwand	pinnen	Wand
Planck-Zeit	Planck	Zeit
Planerin	Planer	in
Planetenbahn	Planet	Bahn
Planetengetriebe	Planet	Getriebe
Planetenjahr	Planet	Jahr
Planetensystem	Planet	System
Planetoid	Planet	oid
Planierraupe	planieren	Raupe
Plansprache	Plan	Sprache
Plantagenwirtschaft	Plantage	Wirtschaft
Plastikfenster	Plastik	Fenster
Plastikfolie	Plastik	Folie
Plastikgranulat	Plastik	Granulat
Plastikrecycling	Plastik	Recycling
Plastiksprengstoff	Plastik	Sprengstoff
Plattenberg	Platte	Berg
Plattwurmart	Plattwurm	Art
Platzangst	Platz	Angst
Pofalte	Po	Falte
Pogopuschel	Pogo	Puschel
Pokalfinale	Pokal	Finale
Polarbär	polar	Bär
Polin	Pole	in
Politikerin	Politiker	in
Politikwissenschaft	Politik	Wissenschaft
Politikwissenschaftlerin	Politikwissenschaftler	in
Polizeidienststelle	Polizei	Dienststelle
Polizeifahrzeug	Polizei	Fahrzeug
Polizeirevier	Polizei	Revier
Polizeistation	Polizei	Station
Polizeiwache	Polizei	Wache
Polizistin	Polizist	in
Popmusikerin	Popmusiker	in
Popsängerin	Popsänger	in
Pornofilm	Porno	Film
Pornofilmchen	Porno	Filmchen
Pornovideo	Porno	Video
Portugiesin	Portugiese	in
Porzellanindustrie	Porzellan	Industrie
Porzellanschale	Porzellan	Schale
Porzellanschnecke	Porzellan	Schnecke
Posaunenbläser	Posaune
Posaunenbläserin	Posaunenbläser	in
Posaunistin	Posaunist	in
Posteingang	Post	Eingang
Postfach	Post	Fach
Postkarte	Post	Karte
Postsack	Post	Sack
Preiselbeermarmelade	Preiselbeere	Marmelade
Preisstufe	Preis	Stufe
Pressefreiheit	Presse	Freiheit
Pressemitteilung	Presse	Mitteilung
Preußin	Preuße	in
Priesterin	Priester	in
Primatologin	Primatologe	in
Produktinformation	Produkt	Information
Produktivitätssteigerung	Produktivität	Steigerung
Produzentin	Produzent	in
Professorin	Professor	in
Profisport	Profi	Sport
Programmdirektorin	Programmdirektor	in
Programmiererin	Programmierer	in
Programmierschnittstelle	programmieren	Schnittstelle
Protagonistin	Protagonist	in
Proteinsequenzierung	Protein	Sequenzierung
Protektorat	protegieren	-at
Protestversammlung	Protest	Versammlung
Protokollchef	Protokoll	Chef
Protostern	proto	Stern
Protzerei	protzen	erei
Prunkschloss	Schloss
Präsidentin	Präsident	in
Pseudowissenschaft	pseudo	Wissenschaft
Psychiaterin	Psychiater	in
Psychoanalytikerin	Psychoanalytiker	in
Psychodrama	psycho	Drama
Psychologin	Psychologe	in
Psychophysik	psycho	Physik
Psychotherapeutin	Psychotherapeut	in
Ptolemäerin	Ptolemäer	in
Publizistin	Publizist	in
Puddingpulver	Pudding	Pulver
Pudelmütze	Pudel	Mütze
Pudelohr	Pudel	Ohr
Pulverschnee	Pulver	Schnee
Pumpenschwengel	Pumpe	Schwengel
Punktlandung	Punkt	Landung
Puppenbühne	Puppe	Bühne
Putzlumpen	putzen	Lumpen
Püppchen	Puppe	chen
Quadratmeter	Quadrat	Meter
Quadratwurzel	Quadrat	Wurzel
Qualifikationsspiel	Qualifikation	Spiel
Qualifikationsturnier	Qualifikation	Turnier
Qualitätskontrolle	Qualität	Kontrolle
Qualitätsmanagement	Qualität	Management
Qualitätssicherung	Qualität	Sicherung
Quarkkuchen	Quark	Kuchen
Quarkstrudel	Quark	Strudel
Quarktorte	Quark	Torte
Quartalsbericht	Quartal	Bericht
Quartalsende	Quartal	Ende
Quellcode	Quelle	Code
Quellenangabe	Quelle	Angabe
Quellenarbeit	Quelle	Arbeit
Radfahren	Rad	Fahren
Radfahrerin	Radfahrer	in
Radierer	radieren	er
Radiererin	Radierer	in
Radiergummi	radieren	Gummi
Radioansprache	Radio	Ansprache
Radiomoderatorin	Radiomoderator	in
Radrennfahrerin	Radrennfahrer	in
Radsportlerin	Radsportler	in
Radunfall	Rad	Unfall
Rahmenerzählung	Rahmen	Erzählung
Rahmenhandlung	Rahmen	Handlung
Rapperin	Rapper	in
Rapskuchen	Raps	Kuchen
Rassepferd	Rasse	Pferd
Ratenbetrag	Rate	Betrag
Ratgeberin	Ratgeber	in
Rathaus	Rat	Haus
Rationalisierungsinvestition	Rationalisierung	Investition
Raubvogel	rauben	Vogel
Raubzug	Raub	Zug
Raucherin	Raucher	in
Rauchfahne	Rauch	Fahne
Raumanzug	Raum	Anzug
Raumdock	Raum	Dock
Raumfahrer	Raum	Fahrer
Raumfahrerin	Raumfahrer	in
Raumfahrtindustrie	Raumfahrt	Industrie
Raumfahrzeug	Raum	Fahrzeug
Raumflotte	Raum	Flotte
Raumflugkörper	Raum	Flugkörper
Raumfähre	Raum	Fähre
Raumschiff	Raum	Schiff
Raumsonde	Raum	Sonde
Raumstation	Raum	Station
Raumzeit	Raum	Zeit
Rebensaft	Rebe	-en	Saft
Rebhuhn	Huhn
Rechenkunde	Kunde	rechnen
Rechenzentrum	rechnen	Zentrum
Rechnernetz	Rechner	Netz
Rechnungsprüfung	Rechnung	Prüfung
Rechtsanwalt	Recht	s	Anwalt
Rechtsanwaltsgesellschaft	Rechtsanwalt	s	Gesellschaft
Rechtsgang	Recht	Gang
Rechtshänderin	Rechtshänder	in
Rechtswissenschaft	Recht	Wissenschaft
Rechtswissenschaftlerin	Rechtswissenschaftler	in
Redakteurin	Redakteur	in
Redaktionsleiterin	Redaktionsleiter	in
Redefreiheit	Rede	Freiheit
Rednerin	Redner	in
Reederin	Reeder	in
Referendarin	Referendar	in
Regenbogen	Regen	Bogen
Regenbogenhaut	Regenbogen	Haut
Regenrinne	Regen	Rinne
Regentropfen	Regen	Tropfen
Regieassistentin	Regieassistent	in
Regierungsassessor	Regierung	Assessor
Regierungsbezirk	Regierung	Bezirk
Regierungschef	Regierung	Chef
Regierungsgebäude	Regierung	Gebäude
Regierungskoalition	Regierung	Koalition
Regierungsmedienkonferenz	Regierung
Regierungsrat	Regierung	Rat
Regierungsreferendar	Regierung	Referendar
Regierungssprecher	Regierung	Sprecher
Regierungsversagen	Regierung	Versagen
Regisseurin	Regisseur	in
Rehohr	Reh	Ohr
Reibungskraft	Reibung	s	Kraft
Reichsbürger	Reich	Bürger
Reichsbürgerin	Reichsbürger	in
Reichskanzlerin	Reichskanzler	in
Reichstag	Reich	Tag
Reichtum	reich	tum
Reihenmittelhaus	mittel-
Reinigungsmilch	Reinigung	Milch
Reinigungsmittel	Reinigung	Mittel
Reinigungstuch	Reinigung	Tuch
Reisebericht	Reise	Bericht
Reisebüro	Reise	Büro
Reisedecke	Reise	Decke
Reiseerinnerung	Reise	Erinnerung
Reiserad	Reise	Rad
Reiserücktrittsversicherung	Reiserücktritt	Versicherung
Reisgericht	Reis	Gericht
Reiskuchen	Reis	Kuchen
Reismilch	Reis	Milch
Reiterin	Reiter	in
Reitsattel	reiten	Sattel
Rektorin	Rektor	in
Religionsfreiheit	Religion	Freiheit
Religionswissenschaft	Religion	Wissenschaft
Rennfahrerin	Rennfahrer	in
Rennradfahrerin	Rennradfahrer	in
Rentnerin	Rentner	in
Repräsentantenhaus	Repräsentant	Haus
Repräsentantin	Repräsentant	in
Reptilienmensch	Mensch	Reptil
Requisitendepot	Requisit	Depot
Researcherin	Researcher	in
Restauratorin	Restaurator	in
Retourkutsche	retour	Kutsche
Rettungsdienst	Rettung	Dienst
Rettungsgasse	Rettung	s	Gasse
Rettungsmannschaft	Rettung	Mannschaft
Rettungsring	Rettung	Ring
Rettungstaucher	Rettung	Taucher
Rettungstaucherin	Rettungstaucher	in
Reviewerin	Reviewer	in
Rhabarberkuchen	Rhabarber	Kuchen
Rhombendodekaeder	Rhombus	Dodekaeder
Richterin	Richter	in
Richtungsadverb	Richtung	Adverb
Riesenangebot	riesen
Riesenanstrengung	riesen
Riesenansturm	riesen
Riesenapparat	riesen
Riesenappetit	riesen
Riesenarbeit	riesen
Riesenaufgebot	riesen
Riesenausmaß	riesen
Riesenbaby	riesen
Riesenbagger	riesen
Riesenbalgerei	riesen
Riesenbau	riesen
Riesenbaum	riesen
Riesenbetrieb	riesen
Riesenbeute	riesen
Riesenbildschirm	riesen
Riesenblamage	riesen
Riesenbofist	riesen
Riesenbrand	riesen
Riesenbrücke	riesen	Brücke
Riesenbuchstabe	riesen
Riesenchance	riesen
Riesendame	riesen
Riesending	riesen
Riesendummheit	riesen
Riesendurst	riesen
Riesenechse	riesen
Rieseneiche	riesen
Riesenelch	riesen
Riesenelefant	riesen
Riesenerfolg	riesen
Riesenfaultier	riesen
Riesenfehler	riesen
Riesenfelge	riesen
Riesenfeuerwerk	riesen
Riesenfindling	riesen
Riesenflop	riesen
Riesenfortschritt	riesen
Riesenfreude	riesen
Riesengarnele	riesen
Riesengefahr	riesen
Riesengehalt	riesen
Riesengeschäft	riesen
Riesengewinn	riesen
Riesenglück	riesen
Riesengröße	riesen
Riesenhai	riesen
Riesenhit	riesen
Riesenhunger	riesen
Riesenkalmar	riesen
Riesenkamel	riesen
Riesenkatastrophe	riesen
Riesenkerl	riesen
Riesenkiste	riesen
Riesenklamauk	riesen
Riesenklappe	riesen
Riesenkompliment	riesen
Riesenkonzern	riesen
Riesenkrabbe	riesen
Riesenkrach	riesen
Riesenkraft	riesen
Riesenkram	riesen
Riesenkrawall	riesen
Riesenkröte	riesen
Riesenkänguru	riesen
Riesenland	riesen
Riesenlaster	riesen
Riesenloch	riesen
Riesenlärm	riesen
Riesenmaschine	riesen
Riesenmaul	riesen
Riesenmolekül	riesen
Riesenpartie	riesen
Riesenpech	riesen
Riesenpfanne	riesen
Riesenplakat	riesen
Riesenpleite	riesen
Riesenportion	riesen
Riesenproblem	riesen
Riesenprofit	riesen
Riesenrad	riesen
Riesenrakete	riesen
Riesenreich	riesen
Riesenrindvieh	riesen
Riesenross	riesen
Riesensalamander	riesen
Riesensatz	riesen
Riesenschaden	riesen
Riesenschaukel	riesen
Riesenschildkröte	riesen
Riesenschlange	riesen
Riesenschlappe	riesen
Riesenschloss	riesen
Riesenschloße	riesen
Riesenschnauzer	riesen
Riesenschritt	riesen
Riesenschwein	riesen
Riesenschweinerei	riesen
Riesenschädel	riesen
Riesenschüssel	riesen
Riesensensation	riesen
Riesenskandal	riesen
Riesenskelett	riesen
Riesenslalom	riesen
Riesenspaß	riesen
Riesenspielzeug	riesen
Riesenstimmung	riesen
Riesenstrauß	riesen
Riesenstrecke	riesen
Riesenstuhl	riesen
Riesenstärke	riesen
Riesensumme	riesen
Riesenungeheuer	riesen
Riesenunternehmen	riesen
Riesenwuchs	riesen
Riesenzelle	riesen
Rindbox	Rind
Rinderauftrieb	Rind
Rinderaufzucht	Rind
Rinderbandwurm	Rind
Rinderbestand	Rind
Rinderbeuschel	Rind
Rinderbouillon	Rind
Rinderbraten	Rind
Rinderbremse	Rind
Rinderbrühe	Rind
Rinderdung	Rind
Rinderfarm	Rind
Rinderfilet	Rind
Rinderfutter	Rind
Rindergebrüll	Rind
Rinderhaar	Rind
Rinderhack	Rind
Rinderherde	Rind
Rinderkamm	Rind
Rinderkeule	Rind
Rinderkombinat	Rind
Rinderkrankheit	Rind
Rinderlende	Rind
Rindermark	Rind
Rindermarkt	Rind
Rinderniere	Rind
Rinderoffenstall	Rind
Rinderohr	Rind	Ohr
Rinderpest	Rind
Rinderragout	Rind
Rinderrasse	Rind
Rinderroulade	Rind
Rinderschlag	Rind
Rinderschmalz	Rind
Rinderschmorbraten	Rind
Rinderschnitzel	Rind
Rinderseuche	Rind
Rinderstall	Rind
Rindersteak	Rind
Rinderstück	Rind
Rindersuppe	Rind
Rindertalg	Rind
Rindertuberkulose	Rind
Rinderwahn	Rind
Rinderwahnsinn	Rind
Rinderzucht	Rind
Rinderzüchter	Rind
Rindfleisch	Rind	Fleisch
Rindfleischetikettierungsüberwachungsaufgabenübertragungsgesetz	Rindfleisch	Etikettierung	Überwachung	Aufgabe	Übertragung	Gesetz
Rindsbrust	Rind
Rindsfett	Rind
Rindsgulasch	Rind
Rindshaut	Rind
Rindsleber	Rind
Rindsleder	Rind
Rindswurst	Rind
Rindszunge	Rind
Rindvieh	Rind
Ringerin	Ringer	in
Ringfinger	Ring	Finger
Ringstraße	Ring	Straße	Strasse
Risikogruppe	Risiko	Gruppe
Ritterin	Ritter	in
Ritterrüstung	Ritter	Rüstung
Rizinusöl	Rizinus	Öl
Rohrblatt	Rohr	Blatt
Rohrblattinstrument	Rohrblatt	Instrument
Rohrohrzucker	roh	Rohrzucker
Rohrzucker	Rohr	Zucker
Rollstuhlsport	Rollstuhl	Sport
Rosenbrötchen	Rose	Brötchen
Rosenkranzmonat	Rosenkranz	Monat
Rosensemmel	Rose	Semmel
Rosenspur	Rose	Spur
Rosinenbrötchen	Rosine	Brötchen
Rosinenpickerei	Rosine
Rosskastanie	Ross	Kastanie
Rotkehlchen	rot	Kehlchen
Rotmilan	rot	Milan
Ruderin	Ruderer	in
Rudrerin	-in	Ruderer
Ruhestand	Ruhe	Stand
Ruhetag	Ruhe	Tag
Ruinenlust	Ruine	n	Lust
Rumänin	Rumäne	in
Rundfunk	rund	Funk
Rundfunkorchester	Rundfunk	Orchester
Russin	Russe	in
Räuberin	Räuber	in
Räuberpistole	Räuber	Pistole
Röckchen	Rock	chen
Röntgenaufnahme	Röntgen	Aufnahme
Röntgenstrahlung	röntgen	Strahlung
Rückenspeck	Rücken	Speck
Saarländerin	Saarländer	in
Saatgutaufzeichnungsverordnung	Saatgut	Aufzeichnung	Verordnung
Saatgutkonfetti	Saatgut	Konfetti
Saatkartoffel	Saat	Kartoffel
Sacharbeit	Arbeit
Sachbearbeiterin	Sachbearbeiter	in
Sachbuchautorin	Sachbuchautor	in
Sackgesicht	Sack	Gesicht
Saisonauftakt	Saison	Auftakt
Saisongeschäft	Saison	Geschäft
Saiteninstrument	Saite	Instrument
Salzbad	Salz	Bad
Salzburgerin	Salzburger	in
Salzgrube	Salz	Grube
Salzgurke	Salz	Gurke
Salzkartoffel	Salz	Kartoffel
Salzlampe	Salz	Lampe
Salzmandel	Salz	Mandel
Salzmühle	Salz	Mühle
Salzsee	Salz	See
Salzstange	Salz	Stange
Salzstraße	Straße	Salz	Strasse
Salzsäule	Salz	Säule
Salzsäure	Salz	Säure
Salzteig	Salz	Teig
Salzwasser	Salz	Wasser
Sammlerin	Sammler	in
Samstagabend	Samstag	Abend
Samstagmittag	Samstag	Mittag
Samstagmorgen	Samstag	Morgen
Samstagnachmittag	Samstag	Nachmittag
Samstagnacht	Samstag	Nacht
Samstagvormittag	Samstag	Vormittag
Samtjacke	Samt	Jacke
Samtrobe	Samt	Robe
Sanddüne	Sand	Düne
Sandkuchen	Sand	Kuchen
Sanduhr	Sand	Uhr
Satellitenbeobachtung	Satellit	Beobachtung
Satellitenbild	Satellit	Bild
Satellitendaten	Satellit	Daten
Satellitenfunk	Satellit	Funk
Satellitenstadt	Satellit	Stadt
Satteldecke	Sattel	Decke
Saturnring	Saturn	Ring
Satzzeichen	Satz	Zeichen
Saubande	sau
Saudi-Araberin	Saudi-Araber	in
Sauerkraut	sauer	Kraut
Sauerkrautsaft	Sauerkraut	Saft
Sauerkrautsuppe	Sauerkraut	Suppe
Sauerstoffmangel	Sauerstoff
Sauerstoffsäure	Sauerstoff	Säure
Sauklaue	sau	Klaue
Saustall	Sau	Stall
Sauwetter	sau	Wetter
Savannenklima	Savanne	Klima
Schachcomputer	Schach	Computer
Schachmeisterschaft	Schach	Meisterschaft
Schachspielerin	Schachspieler	in
Schachweltmeister	Schach	Weltmeister
Schachweltmeisterschaft	Schach	Weltmeisterschaft
Schachzug	Schach	Zug
Schadstoffemission	Schadstoff	Emission
Schafsohr	Schaf	Ohr
Schafsschilddrüse	Schaf	Schilddrüse
Schallplattensalat	Schallplatte
Schaltfläche	Schalter	Fläche
Schattenkrieger	Schatten	Krieger
Schatzinsel	Schatz	Insel
Schatzmeisterin	Schatzmeister	in
Schaumkamm	Schaum
Schauspiel	schauen	Spiel
Schauspielerin	Schauspieler	in
Schauspielhaus	Schauspiel	Haus
Scheidungskind	Scheidung	Kind
Scheidungskrieg	Scheidung	Krieg
Scheinwerfer	Schein	Werfer
Scheiterhaufen	Scheit	Haufen
Scheißkerl	scheiße	Kerl
Schiedsrichterin	Schiedsrichter	in
Schiffbau	Schiff	Bau
Schiffbauindustrie	Schiffbau	Industrie
Schiffchen	Schiff	chen
Schifffahrt	Schiff	Fahrt
Schiffskörper	Schiff	s	Körper
Schiffsmast	Schiff	Mast
Schiffsraum	Schiff	Raum
Schildbürger	Schilda	Bürger
Schilddrüsenautonomie	Schilddrüse	Autonomie
Schilddrüsenchirurgie	Schilddrüse	Chirurgie
Schilddrüsenentfernung	Schilddrüse	Entfernung
Schilddrüsenerkrankung	Schilddrüse	Erkrankung
Schilddrüsenextrakt	Schilddrüse	Extrakt
Schilddrüsenfunktion	Schilddrüse	Funktion
Schilddrüsengewebe	Schilddrüse	Gewebe
Schilddrüsenhormon	Schilddrüse	Hormon
Schilddrüsenlappen	Schilddrüse	Lappen
Schilddrüsenoperation	Schilddrüse	Operation
Schilddrüsenpulver	Schilddrüse	Pulver
Schilddrüsentransplantation	Schilddrüse	Transplantation
Schildkröte	Schild	Kröte
Schilfrohrwebstuhl	Schilfrohr	Webstuhl
Schinkensandwich	Schinken	Sandwich
Schlachterin	Schlachter	in
Schlachthaus	Schlacht	Haus
Schlachthof	Schlacht	Hof
Schlafgemach	schlafen	Gemach
Schlaflosigkeit	schlaflos	igkeit
Schlafmütze	Schlaf	Mütze
Schlafraum	schlafen	Raum
Schlafstube	schlafen	Stube
Schlafzimmer	schlafen	Zimmer
Schlaginstrument	Schlag	Instrument
Schlagstock	Schlag	Stock
Schlaubergerin	Schlauberger	in
Schleimapfel	Schleim	Apfel
Schließfach	schließen	Fach
Schlossanlage	Schloss	Anlage
Schlossbau	Schloss	Bau
Schlosserin	Schlosser	in
Schlossermeisterin	Schlossermeister	in
Schlosskuppel	Schloss	Kuppel
Schlusskonsonant	Schluss	Konsonant
Schlusslicht	Schluss	Licht
Schlüsselindustrie	Schlüssel	Industrie
Schlüsselkind	Schlüssel	Kind
Schlüsselparameter	Schlüssel	Parameter
Schlüsselstelle	Schlüssel	Stelle
Schmerzgrenze	Schmerz	Grenze
Schmierblatt	schmieren	Blatt
Schmirgelpapier	Schmirgel	Papier
Schmuckstein	Schmuck	Stein
Schmutzkampagne	Schmutz	Kampagne
Schnappschuss	schnappen	Schuss
Schnapsglas	Schnaps	Glas
Schnapsidee	Schnaps	Idee
Schnapsladen	Schnaps	Laden
Schnapsleiche	Schnaps	Leiche
Schnapszahl	Schnaps	Zahl
Schnatgang	Schnad	Gang
Schneckenhaus	Schnecke	Haus
Schneckentempo	Schnecke	Tempo
Schneeball	Schnee	Ball
Schneebesen	Schnee	Besen
Schneechaos	Schnee	Chaos
Schneedecke	Schnee	Decke
Schneeflocke	Schnee
Schneekugel	Schnee	Kugel
Schneelandschaft	Schnee	Landschaft
Schneeleopard	Schnee	Leopard
Schneemangel	Schnee	Mangel
Schneemann	Schnee	Mann
Schneeregen	Schnee	Regen
Schneeschuh	Schnee	Schuh
Schneesturm	Schnee	Sturm
Schneiderin	Schneider	in
Schneiderrechnung	Schneider	Rechnung
Schnellbahn	schnell	Bahn
Schnellschuss	schnell	Schuss
Schnellstraße	Straße	schnell	Strasse
Schnittblume	Schnitt	Blume
Schnittstelle	Schnitt	Stelle
Schnäbelchen	Schnabel	chen
Schnürsenkel	schnüren	Senkel
Schokoladenpudding	Schokolade	Pudding
Schokoladentafel	Schokolade	Tafel
Schottländerin	Schottländer	in
Schraubendreher	Schraube	Dreher
Schraubengewinde	Schraube	Gewinde
Schraubenmutter	Schraube	Mutter
Schraubenschlüssel	Schraube	Schlüssel
Schraubenwelle	Schraube	Welle
Schraubenzieher	Schraube	Zieher
Schreihals	Schrei	Hals
Schreinerin	Schreiner	in
Schriftgrad	Schrift	Grad
Schriftgröße	Schrift	Größe
Schriftstellerin	Schriftsteller	in
Schriftzeichen	Schrift	Zeichen
Schrittlänge	Schritt	Länge
Schrottauto	Schrott	Auto
Schrottkarre	Schrott	Karre
Schuhchen	Schuh	chen
Schuhindustrie	Schuh	Industrie
Schuhlöffel	Schuh	Löffel
Schuhmacher	Schuh	Macher
Schuhmacherin	Schuhmacher	in
Schuhwerk	Schuh	werk
Schulbank	Schule	Bank
Schuldnerin	Schuldner	in
Schulgebäude	Schule	Gebäude
Schulgrammatik	Schule	Grammatik
Schuljunge	Schule	Junge
Schulkind	Schule	Kind
Schulleiterin	Schulleiter	in
Schulmädchen	Schule	Mädchen
Schulranzen	Schule	Ranzen
Schultafel	Schule	Tafel
Schultergelenk	Schulter	Gelenk
Schulterstand	Schulter	Stand
Schulweg	Schule	Weg
Schulzimmer	Schule	Zimmer
Schusterin	Schuster	in
Schusterjunge	Schuster	Junge
Schutzgemeinschaft	Schutz	Gemeinschaft
Schwachkopf	schwach	Kopf
Schwachstelle	schwach	Stelle
Schwammtuch	Schwamm	Tuch
Schwangerschaftsabbruch	Schwangerschaft	Abbruch
Schwangerschaftskonflikt	Schwangerschaft	Konflikt
Schwangerschaftsunterbrechung	Schwangerschaft	Unterbrechung
Schwangerschaftsuntersuchung	Schwangerschaft	Untersuchung
Schwanzborste	Schwanz	Borste
Schwarmintelligenz	Schwarm	Intelligenz
Schwartenmagen	Schwarte	Magen
Schwarzschild	schwarz	Schild
Schwarzschildradius	Schwarzschild	Radius
Schwefelholz	Schwefel	Holz
Schweinefleisch	Schwein	Fleisch
Schweineohr	Schwein	Ohr
Schweinestall	Schwein	Stall
Schweizerin	Schweizer	in
Schweizerland	Schweizer	Land
Schwellenland	Schwelle	Land
Schwermetall	schwer	Metall
Schwesterchen	Schwester	chen
Schwesterfirma	Schwester	Firma
Schwestergesellschaft	Schwester	Gesellschaft
Schwesterherz	Schwester	Herz
Schwesterinsel	Schwester	Insel
Schwimmerin	Schwimmer	in
Schwulenbewegung	Schwule
Schwulengruppe	Schwule	Gruppe
Schwulenhochzeit	Schwule
Schwulenklub	Schwule
Schädlingsbekämpfung	Schädling	Bekämpfung
Schädlingsbekämpfungsmittel	Schädling	Bekämpfung	Mittel
Schädlingsbekämpfungsmittelrückstand	Schädlingsbekämpfungsmittel	Rückstand
Schädlingsbekämpfungsmittelrückstandsbeseitigung	Schädlingsbekämpfungsmittelrückstand	Beseitigung
Schönwetterperiode	schön	Wetter	Periode
Schülerin	Schüler	in
Science-Fiction-Serie	Science-Fiction	Serie
Seeaal	See	Aal
Seeigel	See	Igel
Seeleute	See	Leute
Seelsorge	Seele	Sorge
Seelsorgerin	Seelsorger	in
Seelöwe	See	Löwe
Seemann	See	Mann
Seemännin	See	Männin
Seeoffizier	See	Offizier
Seglerin	Segler	in
Seifenblase	Seife	Blase
Seifenschale	Seife	Schale
Seihtuch	seihen	Tuch
Seismikerin	Seismiker	in
Seismologin	Seismologe	in
Seitenachse	Seite	Achse
Sekündchen	Sekunde	chen
Selbstabholerin	Selbstabholer	in
Selbstbildnis	selbst	Bildnis
Selbstporträt	selbst	Porträt
Selenzelle	Selen	Zelle
Seminarbibliothek	Seminar	Bibliothek
Seminarleiterin	Seminarleiter	in
Semmelkloß	Semmel	Kloß
Semmelknödel	Semmel	Knödel
Senatorin	Senator	in
Senfkorn	Senf	Korn
Senföl	Senf	Öl
Septembertag	September	Tag
Sesambrötchen	Sesam	Brötchen
Sesamöl	Sesam	Öl
Sexfilm	Sex	Film
Sexfilmchen	Sex	Filmchen
Sezessionsstil	Sezession	Stil
Shiitakepilz	Shiitake	Pilz
Shishacafé	Shisha	Café
Shogunat	Shogun	at
Sicherheitsabschaltung	Sicherheit	Abschaltung
Sicherheitslücke	Sicherheit	Lücke
Sicherheitspolitik	Sicherheit	Politik
Sicherheitsverfahren	Sicherheit	Verfahren
Sicherheitsvorschrift	Sicherheit	Vorschrift
Sicherheitszone	Sicherheit	Zone
Sichtweite	Sicht	Weite
Siebenschläfer	sieben	Schläfer
Siedlungshaus	Siedlung	Haus
Siegerin	Sieger	in
Silikonchip	Silikon	Chip
Singapurerin	Singapurer	in
Singer-Songwriterin	Singer-Songwriter	in
Sinologin	Sinologe	in
Sinusknoten	Sinus	Knoten
Sirianer	Sirius	er
Sisyphusarbeit	Sisyphus	Arbeit
Sitzfleisch	Sitz	Fleisch
Sitznachbar	sitzen	Nachbar
Skandalnudel	Skandal	Nudel
Skandinavierin	Skandinavier	in
Skischule	Ski	Schule
Skiunfall	Ski	Unfall
Sklaventreiber	Sklave	Treiber
Slowenierin	Slowenier	in
Snookerweltmeisterschaft	Snooker	Weltmeisterschaft
Softwareentwicklerin	Softwareentwickler	in
Sojabohne	Soja	Bohne
Sojaprotein	Soja	Protein
Sojasoße	Sauce	Soja	Sosse	Soße
Sojaspross	Soja	Spross
Solaranlage	solar	Anlage
Solarbatterie	solar	Batterie
Solarfarm	solar	Farm
Solarpaneel	solar	Paneel
Solarzelle	solar	Zelle
Sollbruchstelle	Soll	Bruchstelle
Soloszene	solo	Szene
Sommerferien	Sommer	Ferien
Sommerprogramm	Sommer	Programm
Sommersonnenwende	Sommer	Sonnenwende
Sommersprosse	Sommer	Sprosse
Sommertemperatur	Sommer	Temperatur
Songschreiberin	Songschreiber	in
Sonnabend	Abend
Sonnabendnachmittag	Sonnabend	Nachmittag
Sonnabendvormittag	Sonnabend	Vormittag
Sonnenblume	Sonne	Blume
Sonnenbrand	Sonne	Brand
Sonneneinstrahlung	Sonne	Einstrahlung
Sonnenenergie	Sonne	Energie
Sonnenhut	Sonne	Hut
Sonnenmilch	Sonne	Milch
Sonnenscheibe	Sonne	Scheibe
Sonnenschein	Sonne	Schein
Sonnenstich	Sonne
Sonnenterrasse	Sonne	Terrasse
Sonntagabend	Sonntag	Abend
Sonntagmittag	Sonntag	Mittag
Sonntagmorgen	Sonntag	Morgen
Sonntagnachmittag	Sonntag	Nachmittag
Sonntagnacht	Sonntag	Nacht
Sonntagsfahrverbot	Sonntag	Fahrverbot
Sonntagsfrage	Sonntag	Frage
Sonntagsruhe	Sonntag	Ruhe
Sonntagvormittag	Sonntag	Vormittag
Sopranistin	Sopranist	in
Sowjetzone	Sowjet	Zone
Sozialarbeiter	Arbeiter
Sozialarbeiterin	Sozialarbeiter	in
Sozialistin	Sozialist	in
Soziologin	Soziologe	in
Spammail	Spam	Mail
Spanierin	Spanier	in
Sparkasse	sparen	Kasse
Spaziergang	spazieren	Gang
Spaßvogel	Spaß	Vogel
Speckkuchen	Speck	Kuchen
Speerkies	Speer	Kies
Speicheldrüse	Speichel	Drüse
Speicherkraftwerk	Speicher	Kraftwerk
Speisekarte	Speise	Karte
Speisezimmer	speisen	Zimmer
Spendensammlung	Spende	Sammlung
Sperrmüllentsorgung	Sperrmüll	Entsorgung
Speziesist	Spezies	ist
Spielcasino/Spielkasino	Spiel	spielen	Casino/Kasino
Spielerin	Spieler	in
Spielgerät	spielen	Gerät
Spielkartenfabrik	Spielkarte
Spielkartenmuseum	Spielkarte	Museum
Spielkonsole	Spiel	Konsole
Spielwürfel	Spiel	Würfel
Spielzeit	Spiel	Zeit
Spielzeug	Spiel	spielen	Zeug
Spielzeugindustrie	Spielzeug	Industrie
Spionin	Spion	in
Spiralarm	Spirale	Arm
Spiralgalaxie	Spirale	Galaxie
Spiralnebel	Spirale	Nebel
Spitzhacke	spitz	Hacke
Sportamt	Sport	Amt
Sportanzug	Sport	Anzug
Sportart	Sport	Art
Sportartikel	Sport	Artikel
Sportgerät	Sport	Gerät
Sportladen	Sport	Laden
Sportlehrer	Sport	Lehrer
Sportlerin	Sportler	in
Sportschule	Sport	Schule
Sporttaucherin	Sporttaucher	in
Sportunfall	Sport	Unfall
Sportverein	Sport	Verein
Sportwissenschaft	Sport	Wissenschaft
Sprachassistentin	Sprachassistent	in
Sprachgesetz	Sprache	Gesetz
Sprachlabor	Sprache	Labor
Sprachlandschaft	Sprache	landschaft
Sprachlehrer	Sprache	Lehrer
Sprachlehrerin	Sprachlehrer	in
Sprachniveau	Sprache	Niveau
Sprachwissenschaft	Sprache	Wissenschaft
Sprachwissenschaftlerin	Sprachwissenschaftler	in
Sprecherin	Sprecher	in
Springerin	Springer	in
Springstock	springen	Stock
Sprinterin	Sprinter	in
Spritpreisbremse	Sprit	Preisbremse
Sprungtuch	Sprung	Tuch
Sprungturm	Sprung	Turm
Spuckkuchen	spucken	Kuchen
Spätzchen	Spatz	chen
Spätzlehobel	Spätzle	Hobel
Spülmaschine	spülen	Maschine
Staatengemeinschaft	Staat	en	Gemeinschaft
Staatsanleihe	Staat	Anleihe
Staatsanwalt	Staat	s	Anwalt
Staatsanwaltschaft	Staatsanwalt	schaft
Staatsausgabe	Staat	Ausgabe
Staatsbetrieb	Staat	s	Betrieb
Staatschef	Staat	s	Chef
Staatschefin	Staat	s	Chefin
Staatsdienerin	Staatsdiener	in
Staatseigentum	Staat	s	Eigentum
Staatspolizei	Staat	Polizei
Staatswissenschaft	Staat	Wissenschaft
Stachelbeermarmelade	Stachelbeere	Marmelade
Stadtautobahn	Stadt	Autobahn
Stadtbahn	Stadt	Bahn
Stadtbahnfahrzeug	Stadtbahn	Fahrzeug
Stadtbahnhaltestelle	Stadtbahn	Haltestelle
Stadtbaum	Stadt	Baum
Stadtbaumkonzept	Stadtbaum	Konzept
Stadtbefestigung	Stadt	Befestigung
Stadtentwicklung	Stadt	Entwicklung
Stadtentwicklungsverwaltung	Stadtentwicklung	Verwaltung
Stadtgrenze	Stadt	Grenze
Stadtplanerin	Stadtplaner	in
Stadtrad	Stadt	Rad
Stadttafel	Stadt	Tafel
Stadtwald	Stadt	Wald
Stahlbetonbauerin	Stahlbetonbauer	in
Stahlbetonfertigteil	Stahlbeton	Fertigteil
Stahlindustrie	Stahl	Industrie
Stahlwolle	Stahl	Wolle
Stammbaum	Stamm	Baum
Stammtisch	Stamm	Tisch
Stammtischniveau	Stammtisch	Niveau
Standardaussprache	Standard	Aussprache
Standardkerze	Standard	Kerze
Standpunkt	Stand	Punkt
Statussymbol	Status	Symbol
Steckdosenleiste	Steckdose
Stehzeug	stehen	Zeug
Steigerungsform	Steigerung	Form
Steigerungsgrad	Steigerung	Grad
Steigerungsstufe	Steigerung	Stufe
Steinbock	Stein	Bock
Steinbrucharbeiter	Arbeiter
Steinbrucharbeiterin	Steinbrucharbeiter	in
Steingut	Stein	Gut
Steinpilz	Stein	Pilz
Steinzeitkommunismus	Steinzeit	Kommunismus
Stellarastronomie	stellar	Astronomie
Stellardynamik	stellar	Dynamik
Stellplatz	stellen	Platz
Sternanisöl	Sternanis	Öl
Sternassoziation	Stern	Assoziation
Sternblume	Stern	Blume
Sternchen	Stern	chen
Sternchennudel	Sternchen	Nudel
Sternchensuppe	Sternchen	Suppe
Sterndeuter	Stern	Deuter
Sterndeutung	Stern	Deutung
Sternekoch	Stern	Koch
Sternenauge	Stern	Auge
Sternenflotte	Stern	en	Flotte
Sternenlicht	Stern
Sternenschiff	Stern	Schiff
Sternensystem	Stern	System
Sternhaufen	Stern	Haufen
Sternwind	Stern	Wind
Sternzeichen	Stern	Zeichen
Steuerharmonisierung	Steuer	Harmonisierung
Stiefmutter	stief	Mutter
Stiefmütterchen	Mütterchen	stief-	-chen	Stiefmutter
Stiefvater	stief	Vater
Stielbürste	Stiel	Bürste
Stieleiche	Stiel	Eiche
Stimmabgabe	Stimme	Abgabe
Stimmzettel	stimmen	Zettel	Stimme
Stoffsammlung	Stoff	Sammlung
Stolperstein	stolpern	Stein
Stoßgebet	Stoß	Gebet
Straftat	Strafe	Tat
Straftäterin	Straftäter	in
Straßenbahn	Bahn	Straße	Strasse
Straßenbahnfahrer	Straßenbahn	Fahrer
Straßenbahngleis	Straßenbahn	Gleis
Straßenbahnlinie	Straßenbahn	Linie
Straßenbahnnetz	Straßenbahn	Netz
Straßenbahnunfall	Straßenbahn	Unfall
Straßenbelag	Straße	Strasse
Straßenecke	Straße	Ecke	Strasse
Straßenfegerin	Straßenfeger	in
Straßenkatze	Straße	Katze	Strasse
Straßenkind	Straße	Kind	Strasse
Straßenname	Straße	Name	Strasse
Straßennetz	Straße	Netz	Strasse
Straßenseite	Seite	Straße	Strasse
Straßensperrung	Straße	Sperrung	Strasse
Straßensänger	Straße	Sänger	Strasse
Straßentunnel	Straße	Tunnel	Strasse
Straßenverzeichnis	Straße	Verzeichniß	Verzeichnis	Strasse
Streckennetz	Strecke	Netz
Streicherin	Streicher	in
Streichholzschachtel	Streichholz	Schachtel
Streitkraft	Streit	Kraft
Streitmacht	Streit	Macht
Streuobst	Obst	streuen
Streuobstwiese	Streuobst	Wiese
Streuselkuchen	Streusel	Kuchen
Strichcode	Strich	Code
Strichpunkt	Strich	Punkt
Strichstärke	Strich	Stärke
Strichstärkenkontrast	Strichstärke	n	Kontrast
Strickerin	Stricker	in
Stromkabel	Strom	Kabel
Stromkasten	Strom	Kasten
Stromkreis	Strom	Kreis
Strompreis	Strom	Preis
Stromproduktion	Strom	Produktion
Stromunfall	Strom	Unfall
Strukturformel	Struktur	Formel
Strümpfchen	Strumpf	chen
Stubenbesen	Stube	Besen
Stubenhocker	Stube	n
Stuckateurin	Stuckateur	in
Studentin	Student	in
Stuhlgang	Stuhl	Gang
Stundenhotel	Stunde	Hotel
Stundenlohn	Stunde	Lohn
Sturmwarnung	Sturm	Warnung
Sturzbach	Sturz	Bach
Stäbchen	Stab	chen
Städtchen	Stadt	chen
Stübchen	Stube	chen
Stücklohn	Stück	Lohn
Stündchen	Stunde	chen
Stützpfeiler	stützen	Pfeiler
Subsistenzwirtschaft	Subsistenz	Wirtschaft
Suppengrün	Suppe
Suppenkasper	Suppe	Kasper
Suppenlöffel	Suppe	Löffel
Surinamerin	Surinamer	in
Sushibar	Sushi	Bar
Swasiländerin	Swasiländer	in
Symphonieorchester	Symphonie	Orchester
Synchronschwimmen	synchron	Schwimmen
Synchronschwimmerin	Synchronschwimmer	in
Synchronsprecherin	Synchronsprecher	in
Syrerin	Syrer	in
Systemsoftware	System	Software
Sängerin	Sänger	in
Sättigungsdefizit	Sättigung	Defizit
Säugling	säugen	ling
Söckchen	Socke	chen
Söhnchen	Sohn	chen
Söhnlein	Sohn	lein
Südafrikanerin	Südafrikaner	in
Südkoreaner	Südkorea	er
Südkoreanerin	Südkoreaner	in
Südstadt-Bult	Südstadt	Bult
Südtirolerin	Südtiroler	in
Südwestafrika	Südwest	Afrika
Süppchen	Suppe	chen
Süßkartoffel	süß	Kartoffel
Tabakindustrie	Tabak	Industrie
Tabakraucherin	Tabakraucher	in
Tabellenschlusslicht	Tabelle	Schlusslicht
Tachowelle	Tacho	Welle
Tadschikin	Tadschike	in
Tafelschokolade	Tafel	Schokolade
Tafeltraube	Tafel	Traube
Tagedieb	Tag	Dieb
Tagelohn	Tag	Lohn
Tagesablauf	Tag	Ablauf
Tagesanbruch	Tag	Anbruch
Tagundnachtgleiche	Tag	und	Nacht	Gleiche
Taikonautin	Taikonaut	in
Taiwaner	Taiwan	er
Taiwanerin	Taiwaner	in
Talstation	Tal	Station
Talwand	Tal	Wand
Tante-Emma-Laden	Tante	Emma	Laden
Tanzpaar	Tanz	Paar
Tapeziererin	Tapezierer	in
Tapferkeit	tapfer	keit
Tarnvorrichtung	tarnen	Vorrichtung
Taschenbuch	Tasche	Buch
Taschendieb	Tasche	Dieb
Taschendiebin	Taschendieb	in
Taschengeld	Tasche	Geld
Taschenmesser	Tasche	Messer
Taschenrechner	Tasche	Rechner
Taschentuch	Tasche	Tuch
Taschenuhr	Tasche	Uhr
Tattergreis	tattern	Greis
Taubenpost	Taube	Post
Taubheit	taub	heit
Taucherglocke	Taucher	Glocke
Tauchpartnerin	Tauchpartner	in
Taugenichts	taugen	Nichts
Taxifahrerin	Taxifahrer	in
Teddybär	Bär
Teebaum	Tee	Baum
Teebaumöl	Teebaum	Öl
Teelöffel	Tee	Löffel
Teerseife	Teer	Seife
Teesieb	Tee	Sieb
Teezeremonie	Tee	Zeremonie
Teigling	Teig	ling
Teilchen	Teil	chen
Teilhaberin	Teilhaber	in
Teilherzogtum	Teil	Herzogtum
Teilnehmerin	Teilnehmer	in
Teilnehmerzahl	Teilnehmer	Zahl
Teiltext	Teil	Text
Teilung	Teil	ung
Teilungszahl	Teilung	Zahl
Tektosilikat	tekto	Silikat
Telefonmast	Telefon	Mast
Telefonnummer	Telefon	Nummer
Telekommunikation	tele	Kommunikation
Telekommunikationsdienstleistung	Telekommunikation	Dienstleistung
Telekommunikationsgesellschaft	Telekommunikation	Gesellschaft
Telekommunikationsindustrie	Telekommunikation	Industrie
Telekommunikationsrecht	Telekommunikation	s	Recht
Telekommunikationsunternehmen	Telekommunikation	Unternehmen
Telekommunikationsverbindung	Telekommunikation	Verbindung
Tempelanlage	Tempel	Anlage
Tempelbau	Tempel	Bau
Tempelblock	Tempel	Block
Tempelgesellschaft	Tempel	Gesellschaft
Tempelherr	Tempel	Herr
Tempelprostitution	Tempel	Prostitution
Tempelpyramide	Tempel	Pyramide
Tempelraub	Tempel	Raub
Tempelschatz	Tempel	Schatz
Tempelschildkröte	Tempel	Schildkröte
Tempelschänder	Tempel	Schänder
Tempelschändung	Tempel	Schändung
Tempeltanz	Tempel	Tanz
Tempeltänzerin	Tempel	Tänzerin
Temperaturaufzeichnung	Temperatur	Aufzeichnung
Temperaturbedingung	Temperatur	Bedingung
Temperaturentwicklung	Temperatur	Entwicklung
Temperaturerhöhung	Temperatur	Erhöhung
Temperaturgradient	Temperatur	Gradient
Temperaturobergrenze	Temperatur	Obergrenze
Temperaturspektrum	Temperatur	Spektrum
Temperaturunterschied	Temperatur	Unterschied
Temperaturveränderung	Temperatur	Veränderung
Tempolimit	Tempo	Limit
Tennisball	Tennis	Ball
Tennisspielerin	Tennisspieler	in
Teppichboden	Teppich	Boden
Teppichfliese	Teppich	Fliese
Teppichmesser	Teppich	Messer
Terminplaner	Termin	Planer
Terrorakt	Terror	Akt
Terroranschlag	Terror	Anschlag
Terrorist	Terror	ist
Terroristin	Terrorist	in
Testamentvollstreckerin	Testamentvollstrecker	in
Testergebnis	Test	Ergebnis
Testversion	Test	Version
Textdatei	Text	Datei
Texterin	Texter	in
Textildesignerin	Textildesigner	in
Textilkünstlerin	Textilkünstler	in
Textwissenschaft	Text	Wissenschaft
Thailänderin	Thailänder	in
Theaterbau	Theater	Bau
Theaterbesuch	Theater	Besuch
Theaterbesucher	Theater	Besucher
Theaterbesucherin	Theater	Besucherin
Theatergeschichte	Theater	Geschichte
Theaterintendant	Theater	Intendant
Themenfeld	Thema	Feld
Themenportal	Thema	Portal
Theologin	Theologe	in
Theoretikerin	Theoretiker	in
Therapeutin	Therapeut	in
Therapieverfahren	Therapie	Verfahren
Thronfolgerin	Thronfolger	in
Thunfischindustrie	Thunfisch	Industrie
Thunfischsalat	Thunfisch	Salat
Thymianöl	Thymian	Öl
Tibetanerin	Tibetaner	in
Tibeterin	Tibeter	in
Tierart	Tier	Art
Tierarzt	Tier	Arzt
Tiergarten	Tier	Garten
Tiergehege	Tier	Gehege
Tierhalter	Tier	Halter
Tierknochen	Tier	Knochen
Tierkunde	Tier	kunde
Tierkörper	Tier	Körper
Tierpark	Tier	Park
Tierpflegerin	Tierpfleger	in
Tierschutz	Tier	Schutz
Tiersprache	Tier	Sprache
Tierstimmenarchiv	Tierstimme	Archiv
Tierärztin	Tierarzt	in
Tirolerin	Tiroler	in
Tischbein	Tisch	Bein
Tischbesen	Tisch	Besen
Tischchen	Tisch	chen
Tischdecke	Tisch	Decke
Tischlampe	Tisch	Lampe
Tischlein	Tisch	lein
Tischlerin	Tischler	in
Tischmesser	Tisch	Messer
Tischplatte	Tisch	Platte
Tischreservierung	Tisch	Reservierung
Tischtennis	Tisch	Tennis
Tischtennisball	Tischtennis	Ball
Tischtuch	Tisch	Tuch
Toast-Hawaii	Hawaii
Tochtergesellschaft	Tochter	Gesellschaft
Tochtersprache	Tochter	Sprache
Todesangst	Tod	Angst
Todesdatum	Tod	Datum
Todesfahrt	Tod	Fahrt
Todeskampf	Tod	Kampf
Todesopfer	Tod	Opfer
Todesstrafe	Tod	Strafe
Toilettenbürste	Toilette	Bürste
Toilettenpapier	Toilette	Papier
Toilettenpapierrolle	Toilettenpapier	Rolle
Toilettenpapierrollenhalter	Toilettenpapierrolle	Halter
Tokioer	Tokio	er
Tokioter	Tokio	er
Tokioterin	Tokioter	in
Tollwut	toll	Wut
Tomatenmark	Tomate	Mark
Tomatenpflanze	Tomate	Pflanze
Tomatensaft	Tomate	Saft
Tomatensalat	Tomate	Salat
Tomatensoße	Sauce	Sosse	Tomate	Soße
Tomatensuppe	Tomate	Suppe
Tonart	Ton	Art
Tonboden	Ton	Boden
Tonfarbe	Ton	Farbe
Toningenieur	Ton	Ingenieur
Toningenieurin	Toningenieur	in
Tonmeisterin	Tonmeister	in
Tonträger	Ton	Träger
Topfenstrudel	Topfen	Strudel
Topfpflanze	Topf	Pflanze
Topfreiniger	Topf	Reiniger
Topografin	Topograf	in
Torfrau	Tor	Frau
Torhüterin	Torhüter	in
Tortenboden	Torte	Boden
Tortendiagramm	Torte	Diagramm
Tortenheber	Torte	Heber
Torwart	Tor	Wart
Torwartin	Torwart	in
Totzeit	tot	Zeit
Tourismusindustrie	Tourismus	Industrie
Trainerin	Trainer	in
Trainingsanzug	Training	Anzug
Traktorstrahl	Traktor	Strahl
Transkriptionssystem	Transkription	System
Transportraum	Transport	Raum
Trauerbeflaggung	Trauer	Beflaggung
Trauerbirke	Trauer	Birke
Trauerrede	Trauer	Rede
Travestieshow	Travestie	Show
Treiber	treiben	er
Treibhaus	treiben	Haus
Treibhausgas	Treibhaus	Gas
Treibhausgasausstoß	Treibhausgas	Ausstoß
Treibhausgasemission	Treibhausgas	Emission
Trennungsstrich	Trennung	Strich
Trentinerin	Trentiner	in
Treppenhaus	Treppe	Haus
Treppenwitz	Treppe	Witz
Tretmine	treten	Mine
Trickfilm	Trick	Film
Trinkerin	Trinker	in
Trinkschokolade	Schokolade
Trinkwasser	trinken	Wasser
Trockendock	trocken	Dock
Trockenmilch	trocken	Milch
Trojaner	Troja	er
Trommelbremse	Trommel	Bremse
Trommelofen	Trommel	Ofen
Trompeterin	Trompeter	in
Trägerin	Träger	in
Tränendrüse	Träne	Drüse
Tränengas	Träne	Gas
Tschechin	Tscheche	in
Tschechoslowakin	Tschechoslowake	in
Tsunamiwelle	Tsunami	Welle
Tunichtgut	tun	nicht	gut
Tunwort	tun	Wort
Turkmenin	Turkmene	in
Tuwort	tun	Wort
Typhuseinschleppung	Typhus	Einschleppung
Typografin	Typograf	in
Tänzerin	Tänzer	in
Tätigkeit	tätig	keit
Tätigkeitsform	Tätigkeit	Form
Tätigkeitswort	Tätigkeit	Wort
Täuferin	Täufer	in
Täuscherin	Täuscher	in
Töchterchen	Tochter	chen
Töpferhandwerk	Töpfer	Handwerk
Töpferin	Töpfer	in
Töterin	Töter	in
Türkin	Türke	in
Türklinke	Tür	Klinke
Türzarge	Tür	Zarge
Uferstraße	Ufer	Straße	Strasse
Uhrmacher	Uhr	Macher
Uhrmacherin	Uhrmacher	in
Uhrmachermeister	Uhrmacher	Meister
Uhrwerk	Uhr	Werk
Uhrzeiger	Uhr	Zeiger
Uhrzeigersinn	Uhr	Zeiger	Sinn
Ultraschalluntersuchung	Ultraschall	Untersuchung
Umgebungstemperatur	Umgebung	Temperatur
Umkreis	um	Kreis
Umstandswort	Umstand	Wort
Umwelt	um	Welt
Umweltauswirkung	Umwelt	Auswirkung
Umweltbewegung	Umwelt	Bewegung
Umweltbundesamt	Umwelt	Bundesamt
Umweltgeschichte	Umwelt	Geschichte
Umweltingenieur	Umwelt	Ingenieur
Umweltingenieurin	Umweltingenieur	in
Umweltverschmutzung	Umwelt	Verschmutzung
Umweltverträglichkeitsprüfung	Umweltverträglichkeit	Prüfung
Umweltwissenschaft	Umwelt	Wissenschaft
Umwälzung	umwälzen	ung
Unbedenklichkeitsbescheinigung	Unbedenklichkeit	Bescheinigung
Und-Zeichen	und	Zeichen
Unendlichkeit	unendlich	keit
Ungarin	Ungar	in
Unklarheit	un	Klarheit
Unkraut	un	Kraut
Unmenge	un	Menge
Unterflurhydrant	unterflur	Hydrant
Unterhaltung	unter	Haltung
Unterhaltungsschriftsteller	Unterhaltung	Schriftsteller
Unterhandlung	-ung	unterhandeln
Unterklasse	unter	Klasse
Unterlänge	unter	Länge
Untermalung	untermalen	-ung
Unternehmensberater	Unternehmen	Berater
Unternehmensbeteiligung	Unternehmen	Beteiligung
Unternehmensbeteiligungsgesellschaft	Unternehmensbeteiligung	Gesellschaft
Unternehmensgruppe	Unternehmen	Gruppe
Unternehmenskooperation	Unternehmen	Kooperation
Unternehmensleiterin	Unternehmensleiter	in
Unternehmerin	Unternehmer	in
Unterschrift	unter	Schrift
Unterstützerin	Unterstützer	in
Unterwelt	unter	Welt
Unverpacktladen	unverpackt	Laden
Unverträglichkeit	unverträglich	keit
Unwahrheit	unwahr	heit
Unwetter	un	Wetter
Unzahl	un	Zahl
Uraufführung	uraufführen	ung
Urbarmachung	urbar	Machung
Ureinwohnerin	Ureinwohner	in
Urenkel	ur	Enkel
Urenkelin	ur	Enkelin
Urgroßmutter	ur-	Grossmutter	Großmutter
Urgroßvater	ur-	Großvater	Grossvater
Urheberin	Urheber	in
Urologin	Urologe	in
Uropa	ur	Opa
Uruguayer	Uruguay	er
Uruguayerin	Uruguayer	in
Ururenkel	ur	Urenkel
Ururenkelin	Ururenkel	in
Urvogel	ur	Vogel
Usbekin	Usbeke	in
Vahrenwald-List	Vahrenwald	List
Valenzelektron	Valenz	Elektron
Vanillekipferl	Vanille	Kipferl
Vanillepudding	Vanille	Pudding
Vanilleschote	Vanille
Vanillestange	Vanille	Stange
Vaterbruder	Vater	Bruder
Vaterliebe	Vater	Liebe
Vatersbruder	Vater	Bruder
Vaterschwester	Vater	Schwester
Vatersschwester	Vater	Schwester
Veganerin	Veganer	in
Vegetarianerin	Vegetarianer	in
Vegetarierin	Vegetarier	in
Vegetationsperiode	Vegetation	Periode
Velofahrer	Velo	Fahrer
Velofahrerin	Velofahrer	in
Venusrakete	Venus	Rakete
Veranstaltungsort	Veranstaltung	Ort
Verantwortungsbereich	Verantwortung	Bereich
Verbesserung	verbessern	ung
Verbraucherinformation	Verbraucher	Information
Verbraucherschutz	Verbraucher	Schutz
Verbraucherschützer	Verbraucher	Schützer
Verbrecherin	Verbrecher	in
Verbreitungsgebiet	Verbreitung	Gebiet
Verbrenner	verbrennen	er
Verbrennungsmotor	Verbrennung	Motor
Verbrennungswärme	Verbrennung	Wärme
Vereinigungsfreiheit	Vereinigung	Freiheit
Vererbungslehre	Vererbung	Lehre
Verfahrensvorschrift	Verfahren	Vorschrift
Verfassungsänderung	Verfassung	Änderung
Verflüssigung	verflüssigen	ung
Verfügbarkeit	verfügbar	keit
Vergewaltigerin	Vergewaltiger	in
Vergissmeinnicht	ich	vergessen	nicht
Vergissmeinnichtauge	Vergissmeinnicht	Auge
Vergnügungspark	Vergnügung	s	Park
Vergrößerungsglas	Vergrößerung	Glas
Verhaftung	verhaften	ung
Verhaltensbiologie	Verhalten	Biologie
Verhaltensregel	Verhalten	Regel
Verhaltenswissenschaft	Verhalten	Wissenschaft
Verhandlungspartner	Verhandlung	Partner
Verkaufsautomat	Verkauf	Automat
Verkaufsstart	Verkauf	Start
Verkehrsanbindung	Verkehr	Anbindung
Verkehrsberuhigung	Verkehr	Beruhigung
Verkehrsinfrastruktur	Verkehr	s	Infrastruktur
Verkehrsinfrastrukturmaßnahme	Verkehrsinfrastruktur	Maßnahme
Verkehrsknotenpunkt	Verkehr	s	Knotenpunkt
Verkehrskonzept	Verkehr	s
Verkehrslärm	Verkehr	s	Lärm
Verkehrsminister	Verkehr	Minister
Verkehrspolizistin	Verkehrspolizist	in
Verkehrsstau	Verkehr	Stau
Verkehrsunfall	Verkehr	Unfall
Verkehrsverbot	Verkehr	Verbot
Verkehrswende	Verkehr	Wende
Verkehrszeichen	Verkehr	Zeichen
Verkleinerungsform	Verkleinerung	Form
Verkäuferin	Verkäufer	in
Verlaufsform	Verlauf	Form
Verlegerin	Verleger	in
Verliererin	Verlierer	in
Verlängerungsschnur	Verlängerung	Schnur
Vermieterin	Vermieter	in
Vermittlungsproblem	Vermittlung	Problem
Verneinungswort	Verneinung	Wort
Verpackungsverordnung	Verpackung	Verordnung
Verräterin	Verräter	in
Versalhöhe	Versalie	Höhe
Versammlung	-ung	versammeln
Verschränkung	verschränken	ung
Verschwörungsanhänger	Verschwörung	Anhänger
Verschwörungsanhängerin	Verschwörungsanhänger	in
Verschwörungserzählung	Verschwörung	Erzählung
Verschwörungstheoretiker	Verschwörung	Theoretiker
Verschwörungstheoretikerin	-in	Verschwörungstheoretiker	Verschwörung	Theoretikerin
Versicherungswissenschaft	Versicherung	Wissenschaft
Versorger	versorgen	er
Verstärkungsapparat	Verstärkung	Apparat
Versuchskaninchen	Versuch	Kaninchen
Verteilerin	Verteiler	in
Verteilerkasten	Verteiler	Kasten
Verteilerschlüssel	Verteiler	Schlüssel
Verteilung	ver	Teilung
Verteilungsschlüssel	Verteilung	Schlüssel
Vertragsverletzung	Vertrag	s	Verletzung
Vertragsverletzungsverfahren	Vertragsverletzung	s	Verfahren
Verwalterin	Verwalter	in
Verwaltungswissenschaft	Verwaltung	Wissenschaft
Verwässerungsrisiko	Verwässerung	Risiko
Verzichterklärung	Verzicht	Erklärung
Vetterin	Vetter	in
Videoaufzeichnung	Video	Aufzeichnung
Videodatei	Video	Datei
Videofresko	Video	Fresko
Videokonferensystem	Videokonferenz	System
Videokonferenz	Video	Konferenz
Videokunst	Video	Kunst
Viehweide	Vieh	Weide
Viehwirtschaft	Vieh	Wirtschaft
Vielfältigkeit	vielfältig	keit
Vielzahl	viel	Zahl
Viersternehotel	vier	Stern	Hotel
Vierteldrehung	viertel	Drehung
Viertelfinale	viertel	Finale
Viertelfinalist	viertel	Finalist
Vierteljahrhundert	viertel	Jahrhundert
Viertelstunde	viertel	Stunde
Vietnamesin	Vietnamese	in
Vietnamkrieg	Vietnam	Krieg
Violinistin	Violinist	in
Virologin	Virologe	in
Vizebürgermeisterin	Vizebürgermeister	in
Vizekanzlerin	Vizekanzler	in
Vizepräsidentin	Vizepräsident	in
Vogelart	Vogel	Art
Vogelei	Vogel	Ei
Vogelfutter	Vogel	Futter
Vogelgesang	Vogel	Gesang
Vogelgesicht	Vogel	Gesicht
Vogelgrippe	Vogel	Grippe
Vogelhaus	Vogel	Haus
Vogelkäfig	Vogel	Käfig
Vogelperspektive	Vogel	Perspektive
Vokalistin	Vokalist	in
Vokalmusik	vokal	Musik
Volksabstimmung	Volk	Abstimmung
Volksempfinden	Volk	Empfinden
Volksetymologie	Volk	Etymologie
Volksherrschaft	Volk	Herrschaft
Volksinstrument	Volk	Instrument
Volkskundlerin	Volkskundler	in
Volkspartei	Volk	Partei
Volksrepublik	Volk	Republik
Volksschule	Volk	Schule
Volksschullehrerin	Volksschullehrer	in
Volkssprache	Volk	Sprache
Volkswirtschaft	Volk	Wirtschaft
Volkszählung	Volk	Zählung
Volleyballmannschaft	Volleyball	Mannschaft
Volleyballspielerin	Volleyballspieler	in
Vollpfosten	voll	Pfosten
Vollsaat	voll	Saat
Vollverdrängungspfahl	voll	Verdrängung	s	Pfahl
Vorabendmesse	Vorabend	Messe
Vorarbeiter	Arbeit
Vorarbeiterin	Vorarbeiter	in
Vorderseite	vorder	Seite
Vorgängerin	Vorgänger	in
Vorhang	vor	hängen
Vorjahreswert	Vorjahr	Wert
Vorkriegsintelligenz	vor	Krieg	Intelligenz
Vorlesungsverzeichnis	Vorlesung	Verzeichniß	Verzeichnis
Vorläuferin	Vorläufer	in
Vormieterin	Vormieter	in
Vormund	vor	Mund
Vorratsdatenspeicherung	Vorrat	s	Datenspeicherung
Vorschaubild	Vorschau	Bild
Vorwort	vor	Wort
Vulkanausbruch	Vulkan	Ausbruch
Vulkanfiber	Vulkan	Fiber
Vulkanier	Vulkan	ier
Vulkanierin	Vulkanier	in
Vulkaninsel	Vulkan	Insel
Vulkankrater	Vulkan	Krater
Vulkanologin	Vulkanologe	in
Vögelchen	Vogel	chen
Vöglein	Vogel	lein
Völkermord	Volk	Mord
Waageamt	Waage
Waagebalken	Waage
Waagegeld	Waage
Waagemeister	Waage
Waagenfabrik	Waage
Waagepunkt	Waage
Waagescheit	Waage
Waagschale	Waage
Wachsmalstift	Wachs	Malstift
Wachstube	wachen	Tube	Stube	Wachs
Wadenbeißer	beißen	Wade	-er
Waffeleisen	Waffel
Waffeltüte	Waffel	Tüte
Waffenstillstandsvereinbarung	Waffenstillstand	Vereinbarung
Waffenstillstandsverhandlung	Waffenstillstand	Verhandlung
Wagenlenker	Wagen	Lenker
Wagenlenkerin	Wagen	Lenkerin
Wagentür	Wagen	Tür
Wagnerin	Wagner	in
Wahlberechtigung	Wahl	Berechtigung
Wahlbeteiligung	Wahl	Beteiligung
Wahlbezirk	Wahl	Bezirk
Wahlboykott	Wahl	Boykott
Wahlbündnis	Wahl	Bündnis
Wahlcomputer	Wahl	Computer
Wahlergebnis	Wahl	Ergebnis
Wahlforscher	Wahl	Forscher
Wahlforschung	Wahl	Forschung
Wahlfälschung	Wahl	Fälschung
Wahlgang	Wahl	Gang
Wahlgeheimnis	Wahl	Geheimnis
Wahlheimat	Wahl	Heimat
Wahlkampf	Wahl	Kampf
Wahlkampfmanager	Wahlkampf	Manager
Wahlkommission	Wahl	Kommission
Wahlkreis	Wahl	Kreis
Wahlplakat	Wahl	Plakat
Wahlplattform	Wahl	Plattform
Wahlprogramm	Wahl	Programm
Wahlpropaganda	Wahl	Propaganda
Wahlschein	Wahl	Schein
Wahlschlacht	Wahl	Schlacht
Wahlsonntag	Wahl	Sonntag
Wahlsystem	Wahl	System
Wahltag	Wahl	Tag
Wahlurne	Wahl	Urne
Wahrscheinlichkeit	wahrscheinlich	keit
Wahrscheinlichkeitsrechnung	Wahrscheinlichkeit	Rechnung
Wahrscheinlichkeitsverteilung	Wahrscheinlichkeit	s	Verteilung
Waisenhaus	Waise	n	Haus
Waldbrand	Wald	Brand
Waldeinsamkeit	Wald	Einsamkeit
Waldgiraffe	Wald	Giraffe
Waldkauz	Wald	Kauz
Waldorfschule	Waldorf	Schule
Walfisch	Wal	Fisch
Walliser	Wallis	er
Walöl	Wal	Öl
Wandarm	Wand	Arm
Wandbank	Wand	Bank
Wandbehang	Wand	Behang
Wandbekleidung	Wand	Bekleidung
Wandbespannung	Wand	Bespannung
Wandbett	Wand
Wandbild	Wand	Bild
Wandbord	Wand	Bord
Wandbrett	Wand
Wanddekoration	Wand	Dekoration
Wanddicke	Wand
Wandelkonzert	Wandel	Konzert
Wandflechte	Wand
Wandfliese	Wand	Fliese
Wandfläche	Wand	Fläche
Wandfresko	Wand
Wandfries	Wand
Wandgemälde	Wand	Gemälde
Wandgetäfel	Wand
Wandhaken	Wand
Wandheizung	Wand
Wandkachel	Wand
Wandkalender	Wand
Wandkarte	Wand	Karte
Wandklappbett	Wand
Wandlampe	Wand
Wandleiste	Wand
Wandleuchter	Wand
Wandmalerei	Wand
Wandmosaik	Wand
Wandnische	Wand
Wandpfeiler	Wand
Wandplatte	Wand
Wandputz	Wand
Wandschmuck	Wand
Wandschoner	Wand
Wandschränkchen	Wand
Wandsockel	Wand
Wandstärke	Wand
Wandtafel	Wand
Wandteppich	Wand
Wandthermometer	Wand
Wandtisch	Wand	Tisch
Wandtresor	Wand	Tresor
Wandtäfelung	Wand	Täfelung
Wanduhr	Wand	Uhr
Wandverputz	Wand
Wandverschalung	Wand
Warenautomat	Ware	Automat
Wartungsarbeit	Wartung	Arbeit
Wartungsintervall	Wartung	Intervall
Wartungsmaßnahme	Wartung	Maßnahme
Waschbrettbauch	Waschbrett	Bauch
Waschbär	Bär
Waschlappen	waschen	Lappen
Wasserbombe	Wasser	Bombe
Wasserdampf	Wasser	Dampf
Wasserenergie	Wasser	Energie
Wasserfall	Wasser	Fall
Wasserflasche	Wasser	Flasche
Wasserkraft	Wasser	Kraft
Wasserkraftwerk	Wasser	Kraftwerk
Wasserkreislauf	Wasser	Kreislauf
Wasserkrise	Wasser	Krise
Wasserkühlung	Wasser	Kühlung
Wasserlassen	Wasser	lassen
Wasserläufer	Wasser	Läufer
Wassermann	Wasser	Mann
Wassermelone	Wasser	Melone
Wassermenge	Wasser	Menge
Wasserpegel	Wasser
Wasserpfeifenraucherin	Wasserpfeifenraucher	in
Wassersport	Wasser	Sport
Wasserstoffbrückenbindung	Wasserstoffbrücke	Bindung
Wasserstraße	Straße	Wasser	Strasse
Wasserstrudel	Wasser	Strudel
Wassertemperatur	Wasser	Temperatur
Wassertier	Wasser	Tier
Wasserturm	Wasser	Turm
Wasserversorgung	Wasser	Versorgung
Wasservogel	Wasser	Vogel
Wasserwerfer	Wasser	Werfer
Web-Adresse	Web	Adresse
Web-Applikation	Web	Applikation
Web-Dienst	Web	Dienst
Web-Entwickler	Web	Entwickler
Web-Entwicklerin	Web-Entwickler	in
Web-Radio	Web	Radio
Web-Service	Web	Service
Web-Shop	Web	Shop
Web-Video	Web	Video
Webangebot	Web	Angebot
Webanwendung	Web	Anwendung
Webapplikation	Web	Applikation
Webbrowser	Web	Browser
Webdesign	Web	Design
Webentwicklerin	-in	Web	Web-Entwickler
Weberin	Weber	in
Webgestaltung	Web	Gestaltung
Weblink	Web	Link
Webmaster	Web	Master
Webportal	Web	Portal
Webradio	Web	Radio
Webseite	Web	Seite
Webserver	Web	Server
Webservice	Web	Service
Webshop	Web	Shop
Websperre	Web	Sperre
Webvideo	Web	Video
Webwegweiser	Web	Wegweiser
Wechselbalg	wechseln	Balg
Wecker	wecken	er
Wegbereiterin	Wegbereiter	in
Wegbier	Weg	Bier
Wegkreuz	Weg	Kreuz
Weichkäse	weich	Käse
Weideland	Weide	Land
Weihnachtsabend	Weihnacht	Abend
Weihnachtsansprache	Weihnacht	Ansprache
Weihnachtsarbeit	Weihnacht	Arbeit
Weihnachtsausstellung	Weihnacht	Ausstellung
Weihnachtsbasar	Weihnacht	Basar
Weihnachtsbaum	Weihnacht	Baum
Weihnachtsbaumkugel	Weihnachtsbaum	Kugel
Weihnachtsbaumschmuck	Weihnachtsbaum	Schmuck
Weihnachtsbeihilfe	Weihnacht	Beihilfe
Weihnachtsbescherung	Weihnacht	Bescherung
Weihnachtsbotschaft	Weihnacht	Botschaft
Weihnachtsbrauch	Weihnacht	Brauch
Weihnachtsbrief	Weihnacht	Brief
Weihnachtsbummel	Weihnacht
Weihnachtsbäckerei	Weihnacht	Bäckerei
Weihnachtschoral	Weihnacht	Choral
Weihnachtsdekoration	Weihnacht	Dekoration
Weihnachtsdult	Weihnacht	Dult
Weihnachtseinkauf	Weihnacht	Einkauf
Weihnachtsengel	Weihnacht	Engel
Weihnachtserzählung	Weihnacht	Erzählung
Weihnachtsfeier	Weihnacht	Feier
Weihnachtsfeiertag	Weihnacht	Feiertag
Weihnachtsferien	Weihnacht	Ferien
Weihnachtsfest	Weihnacht	Fest
Weihnachtsfrau	Weihnacht	Frau
Weihnachtsfreude	Weihnacht	Freude
Weihnachtsgabe	Weihnacht	Gabe
Weihnachtsgans	Weihnacht	Gans
Weihnachtsgebäck	Weihnacht	Gebäck
Weihnachtsgedicht	Weihnacht	Gedicht
Weihnachtsgeld	Weihnacht	Geld
Weihnachtsgeschenk	Weihnacht	Geschenk
Weihnachtsgeschichte	Weihnacht	Geschichte
Weihnachtsgeschäft	Weihnacht	Geschäft
Weihnachtsgratifikation	Weihnacht	Gratifikation
Weihnachtsgruß	Weihnacht	Gruß
Weihnachtsgurke	Weihnacht	Gurke
Weihnachtsinsel	Weihnacht	Insel
Weihnachtskaktus	Weihnacht	Kaktus
Weihnachtskarpfen	Weihnacht	Karpfen
Weihnachtskarte	Weihnacht	Karte
Weihnachtskerze	Weihnacht	Kerze
Weihnachtskind	Weihnacht	Kind
Weihnachtsklimbim	Weihnacht	Klimbim
Weihnachtskonzert	Weihnacht	Konzert
Weihnachtskrippe	Weihnacht	Krippe
Weihnachtskugel	Weihnacht	Kugel
Weihnachtslicht	Weihnacht	Licht
Weihnachtslied	Weihnacht	Lied
Weihnachtsliederplatte	Weihnachtslied	Platte
Weihnachtsmann	Weihnacht	Mann
Weihnachtsmarkt	Weihnacht	Markt
Weihnachtsmonat	Weihnacht	Monat
Weihnachtsmärchen	Weihnacht	Märchen
Weihnachtsoratorium	Weihnacht	Oratorium
Weihnachtspaket	Weihnacht	Paket
Weihnachtspapier	Weihnacht	Papier
Weihnachtspause	Weihnacht	Pause
Weihnachtsplatte	Weihnacht	Platte
Weihnachtsplätzchen	Weihnacht	Plätzchen
Weihnachtspost	Weihnacht	Post
Weihnachtspredigt	Weihnacht	Predigt
Weihnachtspreisausschreiben	Weihnacht	Preisausschreiben
Weihnachtspyramide	Weihnacht	Pyramide
Weihnachtsremuneration	Weihnacht	Remuneration
Weihnachtsrevue	Weihnacht	Revue
Weihnachtsrose	Weihnacht	Rose
Weihnachtsrummel	Weihnacht	Rummel
Weihnachtsschmuck	Weihnacht	Schmuck
Weihnachtsspende	Weihnacht	Spende
Weihnachtsspiel	Weihnacht	Spiel
Weihnachtsstern	Weihnacht	Stern
Weihnachtsstimmung	Weihnacht	Stimmung
Weihnachtsstolle	Weihnacht	Stolle
Weihnachtsstollen	Weihnacht	Stollen
Weihnachtsstriezel	Weihnacht
Weihnachtsstube	Weihnacht	Stube
Weihnachtstag	Weihnacht	Tag
Weihnachtstanne	Weihnacht	Tanne
Weihnachtstauwetter	Weihnacht	Tauwetter
Weihnachtsteller	Weihnacht	Teller
Weihnachtstisch	Weihnacht	Tisch
Weihnachtstrubel	Weihnacht	Trubel
Weihnachtsurlaub	Weihnacht	Urlaub
Weihnachtsverkehr	Weihnacht	Verkehr
Weihnachtsvorlesung	Weihnacht	Vorlesung
Weihnachtswoche	Weihnacht	Woche
Weihnachtszauber	Weihnacht	Zauber
Weihnachtszeit	Weihnacht	Zeit
Weihnachtszuwendung	Weihnacht	Zuwendung
Wein-Rose	Wein	Rose
Weinbeere	Wein	Beere
Weinglas	Wein	Glas
Weinkellnerin	Weinkellner	in
Weintraube	Wein	Traube
Weinwirtschaft	Wein	Wirtschaft
Weisheit	weise	heit
Weißei	Weiß	Ei
Weißraum	weiß	Raum
Weißwandreifen	weiß	Wand	Reifen
Wellblech	Welle
Wellenausbreitung	Welle
Wellenbad	Welle	Bad
Wellenband	Welle
Wellenbereich	Welle
Wellenberg	Welle
Wellenbewegung	Welle
Wellenbildung	Welle
Wellenbrandung	Welle
Wellenbrecher	Welle
Wellenfunktion	Welle	Funktion
Wellenfurche	Welle
Wellengang	Welle
Wellenimpuls	Welle
Wellenkamm	Welle
Wellenkraftwerk	Welle
Wellenkreis	Welle
Wellenleistung	Welle	Leistung
Wellenleiter	Welle
Wellenlinie	Welle
Wellenlänge	Welle	Länge
Wellenläufer	Welle
Wellenmechanik	Welle
Wellenoptik	Welle
Wellenplan	Welle
Wellenreiten	Welle
Wellenreiter	Welle
Wellenschlag	Welle
Wellensittich	Welle
Wellenskala	Welle
Wellenspiel	Welle
Wellenstrahlung	Welle
Wellental	Welle
Wellenzug	Welle
Wellhornschnecke	Welle
Wellpappe	Welle
Weltall	Welt	All
Weltanschauung	Welt	Anschauung
Weltbevölkerung	Welt	Bevölkerung
Welteninsel	Welt	Insel
Weltfrieden	Welt	Frieden
Weltföderation	Welt	Föderation
Weltgipfel	Welt	Gipfel
Weltgruppe	Welt	Gruppe
Weltjugendtag	Welt	Jugendtag
Weltkindertag	Welt	Kindertag
Weltkrieg	Welt	Krieg
Weltkugel	Welt	Kugel
Weltmacht	Welt	Macht
Weltmeer	Welt	Meer
Weltmeisterin	Weltmeister	in
Weltmeisterschaft	Welt	Meisterschaft
Weltmeistertitel	Weltmeister	Titel
Weltraum	Welt	Raum
Weltraumabenteuer	Weltraum	Abenteuer
Weltraumagentur	Weltraum	Agentur
Weltraumbahnhof	Weltraum	Bahnhof
Weltraumbehörde	Weltraum	Behörde
Weltraumfahrer	Weltraum	Fahrer
Weltraumfahrstuhl	Weltraum	Fahrstuhl
Weltraumfahrt	Weltraum	Fahrt
Weltraumfahrzeug	Weltraum	Fahrzeug
Weltraumforscher	Weltraum	Forscher
Weltraumforschung	Weltraum	Forschung
Weltraumfähre	Weltraum	Fähre
Weltraumkapsel	Weltraum	Kapsel
Weltraumkrieg	Weltraum	Krieg
Weltraumkrieger	Weltraum	Krieger
Weltraumlabor	Weltraum	Labor
Weltraumlaboratorium	Weltraum	Laboratorium
Weltraummedizin	Weltraum	Medizin
Weltraummission	Weltraum	Mission
Weltraummüll	Weltraum	Müll
Weltraumorganisation	Weltraum	Organisation
Weltraumpilot	Weltraum	Pilot
Weltraumpionier	Weltraum	Pionier
Weltraumprogramm	Weltraum	Programm
Weltraumrakete	Weltraum	Rakete
Weltraumrecht	Weltraum	Recht
Weltraumrendezvous	Weltraum	Rendezvous
Weltraumroboter	Weltraum	Roboter
Weltraumsatellit	Weltraum	Satellit
Weltraumschiff	Weltraum	Schiff
Weltraumschifffahrt	Weltraum	Schifffahrt
Weltraumschrott	Weltraum	Schrott
Weltraumspaziergang	Weltraum	Spaziergang
Weltraumstation	Weltraum	Station
Weltraumtechnologie	Weltraum	Technologie
Weltraumteleskop	Weltraum	Teleskop
Weltraumtourismus	Weltraum	tourismus
Weltraumtourist	Weltraum	Tourist
Weltraumtouristin	Weltraum	Touristin
Weltraumunternehmen	Weltraum	Unternehmen
Weltraumwaffe	Weltraum	Waffe
Weltraumwetter	Weltraum	Wetter
Weltregion	Welt	Region
Weltreich	Welt	Reich
Weltrekord	Welt	Rekord
Weltschmerz	Welt	Schmerz
Weltstadt	Welt	Stadt
Weltuntergang	Welt	Untergang
Werbeblock	werben	Block
Werbeblocker	werben	Blocker
Werbegrafikerin	Werbegrafiker	in
Werbekunde	werben	Kunde
Werbepsychologie	Psychologie
Werbetexterin	Werbetexter	in
Werkbank	Werk	Bank
Werkmeister	Werk	Meister
Werkzeug	Werk	Zeug
Werkzeugkasten	Werkzeug	Kasten
Werkzeugstahl	Werkzeug	Stahl
Wertstofftonne	Wertstoff	Tonne
Wespenstich	Wespe	Stich
Westernmusik	Western	Musik
Wettbewerb	Wette	Bewerb
Wettbewerberin	Wettbewerber	in
Wetterbericht	Wetter	Bericht
Wetterextrem	Wetter	Extrem
Wetterin	Wetter	in
Wetterkatastrophe	Wetter	Katastrophe
Wetterstation	Wetter	Station
Wettervorhersage	Wetter	Vorhersage
Wettkampf	Wette	Kampf
Wichser	wichsen	er
Wichtigtuer	wichtig	tun	er
Wildente	wild	Ente
Wildfrucht	wild	Frucht
Wildschwein	Schwein
Wildschweinjagd	Wildschwein	Jagd
Wildschweinohr	Wildschwein	Ohr
Wildtierpopulation	Wildtier	Population
Willensfreiheit	Wille	Freiheit
Wimmelbild	wimmeln	Bild
Windenergie	Wind	Energie
Windfarm	Wind	Farm
Windgeschwindigkeit	Wind	Geschwindigkeit
Windpark	Wind	Park
Windschutzpflanzung	Windschutz	Pflanzung
Winterferien	Winter	Ferien
Winterkartoffel	Winter	Kartoffel
Wintermonat	Winter	Monat
Winzerin	Winzer	in
Wirbelsturm	Wirbel	Sturm
Wirkungsgrad	Wirkung	Grad
Wirtschaft	Wirt	schaft
Wirtschaftlichkeitsberechnung	Wirtschaftlichkeit	Berechnung
Wirtschaftsforschungsinstitut	Wirtschaftsforschung	Institut
Wirtschaftsförderungsgesellschaft	Wirtschaftsförderung	Gesellschaft
Wirtschaftsgeschichte	Wirtschaft	Geschichte
Wirtschaftsingenieur	Wirtschaft	Ingenieur
Wirtschaftsingenieurin	Wirtschaftsingenieur	in
Wirtschaftskriminalität	Wirtschaft	Kriminalität
Wirtschaftskrise	Wirtschaft	Krise
Wirtschaftspolitik	Wirtschaft	Politik
Wirtschaftsprüfungsgesellschaft	Wirtschaftsprüfung	Gesellschaft
Wirtschaftsreform	Wirtschaft	Reform
Wirtschaftswachstum	Wirtschaft	Wachstum
Wirtschaftswissenschaft	Wirtschaft	Wissenschaft
Wirtschaftswissenschaftlerin	Wirtschaftswissenschaftler	in
Wirtschaftszweig	Wirtschaft	Zweig
Wissenschaft	Wissen	schaft
Wissenschaftlerin	Wissenschaftler	in
Wissenschaftsgeschichte	Wissenschaft	Geschichte
Wissenschaftswissenschaft	Wissenschaft
Wissenschaftszeitvertragsgesetz	Wissenschaft	s	Zeitvertrag	Gesetz
Wochenende	Woche	Ende
Wochenkalender	Woche	Kalender
Wochenlohn	Woche	Lohn
Wochenmarkt	Woche	Markt
Wochentag	Woche	Tag
Wohltätigkeitsveranstaltung	Wohltätigkeit	Veranstaltung
Wohngebäude	wohnen	Gebäude
Wohnstube	wohnen	Stube
Wohnung	wohnen	ung
Wohnungsbesichtigung	Wohnung	Besichtigung
Wohnungsbewerbung	Wohnung	Bewerbung
Wohnungskauf	Wohnung	Kauf
Wohnungskündigung	Wohnung	Kündigung
Wohnungsmarkt	Wohnung	Markt
Wohnungsmarktsituation	Wohnungsmarkt	Situation
Wohnzimmer	wohnen	Zimmer
Wolldecke	Wolle	Decke
Wortart	Wort	Art
Wortbedeutung	Wort	Bedeutung
Wortbildungselement	Wortbildung	Element
Wortherkunft	Wort	Herkunft
Wortliste	Wort	Liste
Wortschatz	Wort	Schatz
Wortspiel	Wort	Spiel
Wortstamm	Wort	Stamm
Wortwitz	Wort	Witz
Wunderquelle	Wunder	Quelle
Wuppertal	Wupper	Tal
Wuppertaler	Wuppertal
Wurmloch	Wurm	Loch
Wurstfinger	Wurst	Finger
Wurzelbehandlung	Wurzel	Behandlung
Wurzelgemüse	Wurzel	Gemüse
Wurzelziehen	Wurzel	ziehen
Wächterin	Wächter	in
Wählerin	Wähler	in
Währungseinheit	Währung	Einheit
Währungsunion	Währung	Union
Wälzer	wälzen	er
Wärmequelle	Wärme	Quelle
Wäscherin	Wäscher	in
Wäscheständer	Wäsche	Ständer
Wörterbuch	Wort	Buch
Wörterverzeichnis	Wort	Verzeichniß	Verzeichnis
Wüstenklima	Wüste	Klima
Wüstenlandschaft	Wüste	Landschaft
Yogalehrerin	Yoga	Lehrerin
Zahlenlotto	Zahl	Lotto
Zahlungsaufforderung	Zahlung	Aufforderung
Zahlungsaufstellung	Zahlung	Aufstellung
Zahlungsausgleich	Zahlung	Ausgleich
Zahlungsmodalität	Zahlung	Modalität
Zahlwort	Zahl	Wort
Zahnarzt	Zahn	Arzt
Zahnarzthelferin	Zahnarzthelfer	in
Zahnarztpraxis	Zahnarzt	Praxis
Zahnbürste	Zahn	Bürste
Zahncrème	Zahn
Zahnersatz	Zahn	Ersatz
Zahnfleisch	Zahn	Fleisch
Zahnkaries	Zahn	Karies
Zahnlabor	Zahn	Labor
Zahnlaut	Zahn	Laut
Zahnlücke	Zahn	Lücke
Zahnpasta	Zahn	Pasta
Zahnrad	Zahn	Rad
Zahnradbahn	Zahnrad	Bahn
Zahnseide	Zahn	Seide
Zahnstock	Zahn	Stock
Zahnwurzel	Zahn	Wurzel
Zahnärztin	Zahnarzt	in
Zapfwelle	zapfen	Welle
Zauberformel	Zauber	Formel
Zauberkraft	Zauber	Kraft
Zauberlehrling	Zauber	Lehrling
Zaubermeister	Zauber	Meister
Zauberspruch	Zauber	Spruch
Zauberstab	Zauber	Stab
Zauberwürfel	Zauber	Würfel
Zebrafink	Zebra	Fink
Zedernholz	Zeder	Holz
Zedernrepublik	Zeder	Republik
Zeichentrickfilm	zeichnen	Trickfilm
Zeichnerin	Zeichner	in
Zeigefinger	zeigen	Finger
Zeitablauf	Zeit	Ablauf
Zeiteinheit	Zeit	Einheit
Zeitempfinden	Zeit	Empfinden
Zeitenwende	Zeit	Wende
Zeitform	Zeit	Form
Zeitfunk	Zeit	Funk
Zeitgefühl	Zeit	Gefühl
Zeitgeist	Zeit	Geist
Zeitkonto	Zeit	Konto
Zeitlohn	Zeit	Lohn
Zeitlupe	Zeit	Lupe
Zeitmesser	Zeit	messen	er
Zeitnot	Zeit	Not
Zeitpunkt	Zeit	Punkt
Zeitraum	Zeit	Raum
Zeitreise	Zeit	Reise
Zeitschrift	Zeit	Schrift
Zeitskala	Zeit	Skala
Zeitspanne	Zeit	Spanne
Zeitumstellung	Zeit	Umstellung
Zeitungsente	Zeitung	Ente
Zeitungsspalte	Zeitung	Spalte
Zeitungswissenschaft	Zeitung	Wissenschaft
Zeitvergleich	Zeit	Vergleich
Zeitverschiebung	Zeit	Verschiebung
Zeitverständnis	Zeit	Verständnis
Zeitvertrag	Zeit	Vertrag
Zeitwort	Zeit	Wort
Zeitzone	Zeit	Zone
Zellkern	Zelle	Kern
Zementindustrie	Zement	Industrie
Zentigon	zenti	Gon
Zentralbahnhof	zentral	Bahnhof
Zentralbank	zentral	Bank
Zerreißprobe	zerreißen	Probe
Zersiedlung	zer	Siedlung
Zettelwirtschaft	Zettel	Wirtschaft
Zeugin	Zeuge	in
Ziegenbock	Ziege	Bock
Ziegenkäse	Ziege	Käse
Ziegenmilch	Ziege	Milch
Ziegenohr	Ziege	Ohr
Zielgruppe	Ziel	Gruppe
Zifferngruppierung	Ziffer	Gruppierung
Zigarettenraucherin	Zigarettenraucher	in
Zigarettenstummel	Zigarette	Stummel
Zigarrenraucherin	Zigarrenraucher	in
Zimmerchen	Zimmer	chen
Zimmertemperatur	Zimmer	Temperatur
Zimmerthermometer	Zimmer	Thermometer
Zinkmangel	Zink	Mangel
Zionistin	Zionist	in
Zitronenbaum	Zitrone	Baum
Zitronencreme	Zitrone	Creme	Crème
Zitroneneis	Zitrone	Eis
Zitronenfalter	Zitrone	Falter
Zitronengeschmack	Zitrone	Geschmack
Zitronenlimonade	Zitrone	Limonade
Zitronenmelisse	Zitrone	Melisse
Zitronenpresse	Zitrone	Presse
Zitronensaft	Zitrone	Saft
Zitronenschale	Zitrone	Schale
Zitronenscheibe	Zitrone	Scheibe
Zitronensäure	Zitrone	Säure
Zitronensäurezyklus	Zitronensäure	Zyklus
Zitronenwasser	Zitrone	Wasser
Zitronenöl	Zitrone	Öl
Zivilisation	zivilisieren	-ation
Zollverwaltungsgesetz	Zollverwaltung	Gesetz
Zoologin	Zoologe	in
Zoroastrierin	Zoroastrier	in
Zottelbär	Zottel	Bär
Zuckerindustrie	Zucker	Industrie
Zuckerpuppe	Zucker	Puppe
Zuckerpüppchen	Zucker	Püppchen
Zuckerstreuer	Zucker	Streuer
Zuckertüte	Zucker	Tüte
Zuckerwatte	Zucker	Watte
Zufallsgröße	Zufall	Größe
Zugangsdatum	Zugang	Datum
Zugfahrt	Zug	Fahrt
Zugführerin	Zugführer	in
Zugluft	Zug	Luft
Zugvogel	Zug	Vogel
Zukunftsforschung	Zukunft	Forschung
Zukunftsfähigkeit	-keit
Zukunftsmusik	Zukunft	Musik
Zulassungsbeschränkung	Zulassung	Beschränkung
Zuleitungsrohr	Zuleitung	Rohr
Zuneigung	zu	Neigung
Zungenbrecher	Zunge	Brecher
Zungenkuss	Zunge	Kuss
Zungenlaut	Zunge	Laut
Zungenwurzel	Zunge	Wurzel
Zusammenarbeit	zusammen	Arbeit
Zusammenfassung	zusammen	Fassung
Zusammenstoß	zusammen	Stoß
Zusatzfeature	Zusatz	Feature
Zuschauerraum	Zuschauer	Raum
Zwangsarbeiterin	Zwangsarbeiter	in
Zweckentfremdung	Zweck	Entfremdung
Zweirad	zwei	Rad
Zweistaatenlösung	zwei	Staat	Lösung
Zwergplanet	Zwerg	Planet
Zwiebelkuchen	Zwiebel	Kuchen
Zwiebelring	Zwiebel	Ring
Zwiebelsuppe	Zwiebel	Suppe
Zwillingsbruder	Zwilling	Bruder
Zwillingsschwester	Zwilling	Schwester
Zwirnerin	Zwirner	in
Zwischenraum	zwischen	Raum
Zyprerin	Zyprer	in
Zyprierin	Zyprier	in
Zypriotin	Zypriot	in
Zöpfchen	Zopf	chen
Züchterin	Züchter	in
Zündholz	zünden	Holz
Zündhölzchen	Zündholz	chen
Zündkerze	zünden	Kerze
aalartig	Aal	artig
aalglatt	Aal
abarbeiten	ab	arbeiten
abballern	ab	ballern
abbeißen	ab	beißen
abbilden	ab	bilden
abbinden	ab	binden
abbrennen	ab	brennen
abchangieren	ab	changieren
abdampfen	ab	dampfen
aberhundert	aber	hundert
abfangen	ab	fangen
abfassen	ab	fassen
abfotografieren	ab	fotografieren
abfrottieren	ab	frottieren
abgeben	ab	geben
abhalten	ab	halten
abhärten	ab	härten
abisolieren	ab	isolieren
abkassieren	ab	kassieren
abklassieren	ab	klassieren
abklassifizieren	ab	klassifizieren
abkommandieren	ab	kommandieren
abkommen	ab	kommen
abmarschieren	ab	marschieren
abmoderieren	ab	moderieren
abmontieren	ab	montieren
abpatrouillieren	ab	patrouillieren
abpipettieren	ab	pipettieren
abqualifizieren	ab	qualifizieren
abrasieren	ab	rasieren
abreagieren	ab	reagieren
abrufbar	abrufen	bar
absaugen	ab	saugen
abschattieren	ab	schattieren
abschließen	ab	schließen
absehen	ab	sehen
abservieren	ab	servieren
absetzen	ab	setzen
abtelefonieren	ab	telefonieren
abtrainieren	ab	trainieren
abtransportieren	ab	transportieren
achttausend	acht	tausend
achtzehn	acht	zehn
achtzig	acht	zig
affenartig	Affe	artig
affengeil	affen	geil
affenstark	affen	stark
altklug	alt	klug
am	das	an
anbeißen	an	beißen
anbinden	an	binden
anbrennen	an	brennen
anfangen	an	fangen
anfordern	an	fordern
angenehm	an	genehm
anheben	an	heben
anhören	an	hören
anknipsen	an	knipsen
ankommen	an	kommen
anlegen	an	legen
anmachen	an	machen
anmoderieren	an	moderieren
anprobieren	an	probieren
anrichten	an	richten
ans	an	das
ansatzweise	Ansatz	weise
ansehen	an	sehen
anstehen	an	stehen
antaillieren	an	taillieren
antimonarchistisch	anti	monarchistisch
antippen	an	tippen
antitrinitarisch	Antitrinitarier	isch
antrainieren	an	trainieren
antreten	an	treten
anvisieren	an	visieren
anweisen	an	weisen
anwenden	an	wenden
apfelrund	Apfel	rund
arbeiterfreundlich	Arbeiter
arbeitsaufwendig	Arbeit
arbeitsaufwändig	Arbeit
arbeitsintensiv	Arbeit
arbeitslos	Arbeit
arbeitslustig	Arbeit
arbeitsrechtlich	Arbeit
arbeitsscheu	Arbeit
arbeitssparend	Arbeit
arbeitssuchend	Arbeit
arbeitsuchend	Arbeit
arbeitsunfähig	Arbeit
arbeitswillig	Arbeit
atombombensicher	Atombombe	sicher
auf'm	auf	das
aufaddieren	auf	addieren
aufarbeiten	auf	arbeiten
aufatmen	auf	atmen
aufbeißen	auf	beißen
auffangen	auf	fangen
auffrisieren	auf	frisieren
aufgeben	auf	geben
aufgreifen	auf	greifen
aufhalten	auf	halten
aufheben	auf	heben
aufhören	auf	hören
auflaufen	auf	laufen
aufm	auf	das
aufmarschieren	auf	marschieren
aufnehmen	auf	nehmen
aufoktroyieren	auf	oktroyieren
aufpolieren	auf	polieren
aufprobieren	auf	probieren
aufs	auf	das
aufsehen	auf	sehen
aufsetzen	auf	setzen
aufteilen	auf	teilen
auftragen	auf	tragen
aufweisen	auf	weisen
aus'm	aus	das
ausagieren	aus	agieren
ausarbeiten	aus	arbeiten
ausatmen	aus	atmen
ausbilden	aus	bilden
ausbrennen	aus	brennen
auschecken	aus	checken
ausdiskutieren	aus	diskutieren
auseinanderbiegen	auseinander
auseinanderdividieren	auseinander	dividieren
auseinanderfitzen	auseinander	fitzen
ausfinanzieren	aus	finanzieren
ausformulieren	aus	formulieren
ausführen	aus	führen
ausgehen	aus	gehen
ausgrenzen	aus	grenzen
ausklarieren	aus	klarieren
ausknipsen	aus	knipsen
auskristallisieren	aus	kristallisieren
auskurieren	aus	kurieren
auslesen	aus	lesen
ausm	aus	das
ausmachen	aus	machen
ausmanövrieren	aus	manövrieren
ausmarschieren	aus	marschieren
ausmontieren	aus	montieren
ausmöblieren	aus	möblieren
ausnahmsweise	Ausnahme	weise
ausprobieren	aus	probieren
ausquartieren	aus	quartieren
ausradieren	aus	radieren
ausrichten	aus	richten
ausruhen	aus	ruhen
ausscheiden	aus	scheiden
ausschlafen	aus	schlafen
ausschließen	aus	schließen
ausschmieren	aus	schmieren
aussehen	aus	sehen
aussetzen	aus	setzen
aussortieren	aus	sortieren
ausspionieren	aus	spionieren
ausstaffieren	aus	staffieren
ausstellen	aus	stellen
ausstrahlen	aus	strahlen
austapezieren	aus	tapezieren
austarieren	aus	tarieren
austreiben	aus	treiben
ausweisen	aus	weisen
auswählen	aus	wählen
auszeichnen	aus	zeichnen
ausziehen	aus	ziehen
barrierefrei	Barriere	frei
bauchfrei	Bauch	frei
bearbeiten	be	arbeiten
bedeutungsschwanger	Bedeutung	s	schwanger
beflaggen	be	flaggen
begeisterungsfähig	Begeisterung	fähig
behalten	be	halten
beim	bei	das
beisetzen	bei	setzen
beispielsweise	Beispiel	weise
beitragen	bei	tragen
bekomplimentieren	be	komplimentieren
belastungsfähig	Belastung	fähig
berichten	be	richten
beschenken	be	schenken
beschließen	be	schließen
bestehen	be	stehen
bestellen	be	stellen
bezeichnen	be	zeichnen
beziehen	be	ziehen
blauäugig	blau
blitzschnell	Blitz	schnell
bärenhaft	Bär	haft
cremefarben	-farben	Creme	Crème
darstellen	dar	stellen
dazutun	dazu	tun
dickwandig	dick	Wand	ig
diesmal	dieser	Mal
doppelbegabt	doppel
doppelchörig	doppel
doppeldeutig	doppel
doppelgesichtig	doppel
doppelgleisig	doppel
doppelklicken	doppel
doppelkohlensauer	doppel
doppelköpfig	doppel
doppelläufig	doppel
doppelrandig	doppel
doppelreihig	doppel
doppelschichtig	doppel
doppelschläfig	doppel
doppelschläfrig	doppel
doppelschneidig	doppel
doppelseitig	doppel
doppelspurig	doppel
doppelstöckig	doppel
doppeltgemoppelt	doppelt	gemoppelt
doppeltürig	doppel
doppeltürmig	doppel
doppelwandig	doppel	Wand	ig
doppelwertig	doppel
doppelzüngig	doppel
downloadbar	downloaden	bar
dreieckig	drei	eckig
dreiunddreißig	drei	und	dreißig
dreiundzwanzig	drei	und	zwanzig
dreizehn	drei	zehn
dreißig	drei	ßig
durcharbeiten	durch	arbeiten
durchbeißen	durch	beißen
durchbrennen	durch	brennen
durchexerzieren	durch	exerzieren
durchführen	durch	führen
durchkomponieren	durch	komponieren
durchmarschieren	durch	marschieren
durchnummerieren	durch	nummerieren
durchorganisieren	durch	organisieren
durchprobieren	durch	probieren
durchrationalisieren	durch	rationalisieren
durchs	durch	das
ebenso	eben	so
eimerweise	Eimer	weise
einatmen	ein	atmen
einbalsamieren	ein	balsamieren
einbiegen	ein	biegen
einbilden	ein	bilden
einbrennen	ein	brennen
einexerzieren	ein	exerzieren
einfangen	ein	fangen
einfiltrieren	ein	filtrieren
einfügen	ein	fügen
einführen	ein	führen
eingeben	ein	geben
eingravieren	ein	gravieren
eingruppieren	ein	gruppieren
einlegen	ein	legen
einmarschieren	ein	marschieren
einmassieren	ein	massieren
einprägen	ein	prägen
einquartieren	ein	quartieren
einrichten	ein	richten
einsetzen	ein	setzen
einsilieren	ein	silieren
einsortieren	ein	sortieren
einstellen	ein	stellen
einstudieren	ein	studieren
eintippen	ein	tippen
eintrainieren	ein	trainieren
einundzwanzig	eins	und	zwanzig
einziehen	ein	ziehen
elektroakustisch	elektro
elektrochemisch	elektro
elektrodynamisch	elektro
elektromagnetisch	elektro
elektromechanisch	elektro
elektromotorisch	elektro
elektrophil	elektro
elektrophob	elektro
elektropolieren	elektro
elektrosensibel	elektro
elektrotechnisch	elektro
entbürokratisieren	ent	bürokratisieren
entdemokratisieren	ent	demokratisieren
entdämonisieren	ent	dämonisieren
entemotionalisieren	ent	emotionalisieren
entgegenarbeiten	entgegen	arbeiten
entgittern	ent	Gitter
enthalten	ent	halten
entideologisieren	ent	ideologisieren
entindividualisieren	ent	individualisieren
entkriminalisieren	ent	kriminalisieren
entlanggehen	entlang	gehen
entmaterialisieren	ent	materialisieren
entmilitarisieren	ent	militarisieren
entmobilisieren	ent	mobilisieren
entnationalisieren	ent	nationalisieren
entpersonalisieren	ent	personalisieren
entpolitisieren	ent	politisieren
entproblematisieren	ent	problematisieren
entsolidarisieren	ent	solidarisieren
entstehen	ent	stehen
entzweibeißen	entzwei	beißen
erblicken	er	blicken
erfassen	er	fassen
ergeben	er	geben
erhalten	er	halten
erinnern	er
erkennen	er	kennen
erklären	er
erleben	er	leben
erlegen	er
erobern	er
erproben	er	proben
errichten	er	richten
ersatzweise	Ersatz	weise
erschaffen	er	schaffen
ersehen	er	sehen
ersetzen	er	setzen
erstatten	er
erstellen	er	stellen
erweisen	er	weisen
erwünschen	er	wünschen
essbar	essen	bar
esslöffelweise	Esslöffel	weise
faustdick	Faust	dick
faustgroß	gross	groß	Faust
federleicht	Feder
fehlbilden	fehl	bilden
fehlinterpretieren	fehl	interpretieren
firmeneigen	Firma	eigen
fis-Moll-Tonleiter	fis-Moll	Tonleiter
fischreich	Fisch	reich
flaschenweise	Flasche	weise
fortbewegen	fort
fortführen	fort	führen
fortnehmen	fort	nehmen
freundlicherweise	freundlich	weise
furztrocken	furz	trocken
führbar	führen	bar
fünfundzwanzig	fünf	und	zwanzig
fünfzehn	fünf	zehn
fünfzig	fünf	zig
fünfzigjährig	fünfzig	jährig
fünfzigtausend	fünfzig	tausend
g-Moll-Tonleiter	g-Moll	Tonleiter
gehörlos	Gehör	los
gelbrot	gelb	rot
geldhungrig	Geld
gesundheitshalber	Gesundheit	halber
gis-Moll-Tonleiter	gis-Moll	Tonleiter
großmundig	gross	Mund	groß	-ig
h-Moll-Tonleiter	h-Moll	Tonleiter
hammeraffengeil	Hammer	affengeil
hellblau	hell	blau
herabbrennen	herab	brennen
herabgehen	herab	gehen
heranschaffen	heran	schaffen
heraufbiegen	herauf
herausarbeiten	heraus	arbeiten
herausbeißen	heraus	beißen
herausbilden	heraus	bilden
herausdestillieren	heraus	destillieren
herausgeben	heraus	geben
herauskristallisieren	heraus	kristallisieren
herausströmen	heraus	strömen
herbeizitieren	herbei	zitieren
hereinspazieren	herein	spazieren
herleiten	her	leiten
herstellen	her	stellen
herumexperimentieren	herum	experimentieren
herumkritisieren	herum	kritisieren
herunterbiegen	herunter
herunterbrennen	herunter	brennen
hervorbilden	hervor	bilden
hervorragen	hervor	ragen
hinausbeißen	hinaus	beißen
hineinbeißen	hinein	beißen
hineininterpretieren	hinein	interpretieren
hinkommen	hin	kommen
hinrichten	hin	richten
hinterm	hinter	das
hinters	hinter	das
hinunterstürzen	hinunter	stürzen
hochgestochen	hoch	gestochen
hochstilisieren	hoch	stilisieren
hundeartig	Hund	artig
hundeelend	hunde	elend
hundefrei	Hund	frei
hundefreundlich	Hund	freundlich
hundeähnlich	Hund	ähnlich
hörbar	hören	bar
im	in	das
ins	in	das
intelligenzintensiv	Intelligenz	intensiv
interstellar	inter	stellar
irrelevant	ir	relevant
islamisch	Islam	isch
jein	ja	nein
kannenweise	Kanne	weise
keilförmig	Keil	Form	ig
krankenversicherungspflichtig	Krankenversicherung	pflichtig
kulturgeschichtlich	Kulturgeschichte	lich
landwirtschaftlich	Landwirtschaft	lich
lichtarm	Licht	arm
lieferbar	liefern	bar
losbinden	los	binden
losmarschieren	los	marschieren
löffelweise	Löffel	weise
missbrauchen	miss	brauchen
missinterpretieren	miss	interpretieren
mitempfinden	mit	empfinden
mitfinanzieren	mit	finanzieren
mitfühlen	mit	fühlen
mitmachen	mit	machen
mitmarschieren	mit	marschieren
mitnehmen	mit	nehmen
mitregieren	mit	regieren
mittelalt	mittel
mittelblond	mittel
mitteldeutsch	mittel
mittelenglisch	mittel
mittelfristig	mittel
mittelgut	mittel
mittelhochdeutsch	mittel
mittellateinisch	mittel
mittelniederdeutsch	mittel
mittelosteuropäisch	mittel
mittelschlächtig	mittel
mittelständig	mittel
monarchistisch	Monarchist	isch
mondbeglänzt	Mond
mondbeschienen	Mond
mondbestrahlt	Mond
mondhell	Mond
mondsüchtig	Mond
nachbrennen	nach	brennen
nachdatieren	nach	datieren
nachfinanzieren	nach	finanzieren
nachjustieren	nach	justieren
nachkommen	nach	kommen
nachkontrollieren	nach	kontrollieren
nachnominieren	nach	nominieren
nachpolieren	nach	polieren
nachspionieren	nach	spionieren
neulich	neu	lich
neunzehn	neun	zehn
neunzig	neun	zig
niederbrennen	nieder	brennen
notwendig	Not	wendig
null-acht-fünfzehn	null	acht	fünfzehn
oberaffengeil	ober	affengeil
omatauglich	Oma	tauglich
quadrieren	quadr	ieren
quasistellar	quasi	stellar
rausbeißen	raus	beißen
rehbraun	Reh	braun
rindern	Rind
rumkommandieren	rum	kommandieren
sackweise	Sack	weise
salzig	Salz	ig
saubillig	sau	billig
saublöd	sau	blöd
saubrav	sau	brav
saudumm	sau	dumm
saufrech	sau	frech
saugut	sau	gut
saukalt	sau	kalt
saulang	sau	lang
sauschlecht	sau	schlecht
sauteuer	sau	teuer
schwadronsweise	Schwadron	weise
schwarzbrennen	schwarz	brennen
schwarzkopieren	schwarz	kopieren
sechsundneunzig	sechs	und	neunzig
sechsundzwanzig	sechs	und	zwanzig
sechzehn	sechs	zehn
sechzig	sechs	zig
serifenlos	Serife	los
sichtbar	Sicht	bar
siebenundzwanzig	sieben	und	zwanzig
siebzehn	sieben	zehn
siebzig	sieben	zig
sodann	so	dann
steinreich	Stein	reich
steinzeitlich	Steinzeit	lich
stärken	stark	Stärke
teelöffelweise	Teelöffel	weise
tomatenrot	Tomate	rot
transgalaktisch	trans	galaktisch
umadressieren	um	adressieren
umbenennen	um	benennen
umbeschreiben	um	beschreiben
umbesinnen	um	besinnen
umbestellen	um	bestellen
umbrausen	um	brausen
umbringen	um	bringen
umdatieren	um	datieren
umdefinieren	um	definieren
umdekorieren	um	dekorieren
umdenken	um	denken
umdirigieren	um	dirigieren
umdisponieren	um	disponieren
umentscheiden	um	entscheiden
umetikettieren	um	etikettieren
umfinanzieren	um	finanzieren
umfirmieren	um	firmieren
umformatieren	um	formatieren
umformulieren	um	formulieren
umfrisieren	um	frisieren
umfunktionieren	um	funktionieren
umgarnen	um	garnen
umgruppieren	um	gruppieren
umhinkommen	umhin	kommen
umhinkönnen	umhin	können
uminterpretieren	um	interpretieren
umkopieren	um	kopieren
umlackieren	um	lackieren
umorganisieren	um	organisieren
umorientieren	um	orientieren
umprogrammieren	um	programmieren
umquartieren	um	quartieren
umrangieren	um	rangieren
ums	um	das
umschiffen	um	schiffen
umsetzen	um	setzen
umsortieren	um	sortieren
umsteigen	um	steigen
umstrukturieren	um	strukturieren
umwälzen	um	wälzen
und/oder	und	oder
unendlich	un	endlich
unersetzbar	un	ersetzbar
unrasiert	un	rasiert
unsagbar	un	sagbar
unterflur	unter	Flur
unterm	das	unter
unters	unter	das
unverpackt	un	verpackt
unverträglich	un	verträglich
unwahr	un	wahr
verarbeiten	ver	arbeiten
verbarrikadieren	ver	barrikadieren
verbeißen	ver	beißen
verblüffen	ver
verbreiten	ver	breiten
verbürokratisieren	ver	bürokratisieren
verehren	ver	ehren
vereisen	ver	eisen
verfassen	ver	fassen
verfügbar	verfügen	bar
vergaloppieren	ver	galoppieren
vergeben	ver	geben
verhinderbar	verhindern	bar
verirren	ver	irren
verkaufen	ver	kaufen
verlegen	ver	legen
vermeidbar	vermeiden	bar
verpolitisieren	ver	politisieren
verproletarisieren	ver	proletarisieren
verproviantieren	ver	proviantieren
verreisen	ver	reisen
verschneien	ver	schneien
versehen	ver	sehen
versetzen	ver	setzen
versorgen	ver	sorgen
verstehen	ver	stehen
verteilen	ver	teilen
vertraglich	Vertrag	lich
vertreten	ver	treten
verträglich	vertragen	lich
verwirren	ver	wirr
verzagen	ver	zagen
verzeichnen	ver	zeichnen
vierundzwanzig	vier	und	zwanzig
vierzehn	vier	zehn
vierzig	vier	zig
vollmundig	voll	Mund	ig
vom	das	von
vordatieren	vor	datieren
vorexerzieren	vor	exerzieren
vorfabrizieren	vor	fabrizieren
vorfinanzieren	vor	finanzieren
vorformulieren	vor	formulieren
vorheizen	vor	heizen
vorinformieren	vor	informieren
vorm	vor	das
vormagnetisieren	vor	magnetisieren
vornehmen	vor	nehmen
vorprogrammieren	vor	programmieren
vors	vor	das
vorwegnehmen	vorweg	nehmen
vorwegsagen	vorweg	sagen
vorwegschicken	vorweg
waagrecht	Waage
wahrnehmbar	wahrnehmen	bar
wahrnehmen	wahr	nehmen
wahrscheinlich	wahr	schein	lich
wandhängend	Wand
warmherzig	warm	herzig
webbasiert	Web	basiert
wechselweise	Wechsel	weise
wegarbeiten	weg	arbeiten
wegbeißen	weg	beißen
wegbilden	weg	bilden
wegbrennen	weg	brennen
wegdiskutieren	weg	diskutieren
wegfangen	weg	fangen
wegnehmen	weg	nehmen
wegradieren	weg	radieren
wegrasieren	weg	rasieren
wegrationalisieren	weg	rationalisieren
wegsanieren	weg	sanieren
wegtilgen	weg	tilgen
weiterarbeiten	weiter	arbeiten
weiterbilden	weiter	bilden
weiterqualifizieren	weiter	qualifizieren
wellenartig	Welle
wellenförmig	Welle
wellig	Welle
widerspruchsfrei	Widerspruch	s	frei
widerstehen	wider	stehen
wikipedieren	Wikipedia	ieren
witzlos	Witz	los
zerbeißen	zer	beißen
zubeißen	zu	beißen
zubetonieren	zu	betonieren
zugeben	zu	geben
zum	zu	das
zunehmen	zu	nehmen
zur	zu	der
zurechtbringen	zurecht	bringen
zurückbilden	zurück	bilden
zurückgeben	zurück	geben
zusammenarbeiten	zusammen	arbeiten
zusammenbeißen	zusammen	beißen
zusammenfassen	zusammen	fassen
zusammenfügen	zusammen	fügen
zusammenhalten	zusammen	halten
zusetzen	zu	setzen
zuteilen	zu	teilen
zuweisen	zu	weisen
zwanzig	zwei	zig
zweiundvierzig	zwei	und	vierzig
zweiundzwanzig	zwei	und	zwanzig
zwischenfinanzieren	zwischen	finanzieren
zwölfhundert	zwölf	hundert
zwölftausend	zwölf	tausend
Ägypterin	Ägypter	in
Ägyptologin	Ägyptologe	in
Äpfelchen	Apfel	chen
Äquatorialguineerin	Äquatorialguineer	in
Ärmling	Arm	ling
Ärztin	Arzt	in
Ästchen	Ast	chen
Ästlein	Ast	lein
Äthiopierin	Äthiopier	in
Öffnungszeit	Öffnung	Zeit
Ökologie	öko	logie
Ökologiebewegung	Ökologie	Bewegung
Ökonomin	Ökonom	in
Ökosteuer	öko	Steuer
Ökosystem	öko	System
Ökosystemdienstleistung	Ökosystem	Dienstleistung
Ökozidgesetz	Ökozid	Gesetz
Ölfarbe	Öl	Farbe
Ölfleck	Öl
Ölgemälde	Öl	Gemälde
Ölheizung	Öl	Heizung
Ölkanne	Öl	Kanne
Ölkrise	Öl	Krise
Öllampe	Öl	Lampe
Ölluftpumpe	Öl	Luftpumpe
Ölmalerei	Öl	Malerei
Ölproduktion	Öl	Produktion
Örtchen	Ort	chen
Österreicherin	Österreicher	in
Überflutung	überfluten	ung
Übergang	über	Gang
Übergangsmaßnahme	Übergang	Maßnahme
Übergangsmetall	Übergang	Metall
Überlebenswahrscheinlichkeit	Überleben	Wahrscheinlichkeit
Überlichtgeschwindigkeit	über	Lichtgeschwindigkeit
Überschwemmung	überschwemmen	ung
Übersetzerin	Übersetzer	in
Übersetzungsbüro	Übersetzung	Büro
Übersetzungswörterbuch	Übersetzung	Wörterbuch
Übertragungsweg	Übertragung	Weg
Überwachungsanforderung	Überwachung	Anforderung
Überwachungsstrategie	Überwachung	Strategie
Überwachungszweck	Überwachung	Zweck
überdimensionieren	über	dimensionieren
überdosieren	über	dosieren
überführbar	überführen	bar
übergangsweise	Übergang	weise
übergeben	über	geben
überheizen	über	heizen
überholen	über	holen
überm	das	über
übermorgen	über	Morgen
überorganisieren	über	organisieren
überreagieren	über	reagieren
überreden	über	reden
übers	über	das
übersehen	über	sehen
überstehen	über	stehen
überstrapazieren	über	strapazieren
übertreiben	über	treiben
Neanderthaler	Neandertal	Neanderthal	-er
Wörterverzeichniß	Wort	Verzeichniß	Verzeichnis
Sojasauce	Sauce	Soja	Sosse	Soße
Fliessgewässer	Fliess	Gewässer	Fließ
Fussball	Fuss	Fuß	Ball
Fussballer	Fußball	Fussball	-er
Fussballerin	-in	Fußballer	Fussballer
Fussballeuropameisterschaft	Fußball	Fussball	Europameisterschaft
Fussballfeld	Fußball	Feld	Fussball
Fussballmannschaft	Fußball	Fussball	Mannschaft
Fussballplatz	Fußball	Platz	Fussball
Fussballspiel	Spiel	Fußball	Fussball
Fussballspieler	Fußball	Spieler	Fussball
Fussballspielerin	-in	Fußballspieler	Fussballspieler
Fussballstadion	Fußball	Stadion	Fussball
Fussballtor	Fußball	Tor	Fussball
Fussballtrainer	Fußball	Trainer	Fussball
Fussballtrainerin	-in	Fußballtrainer	Fussballtrainer
Fussballtraining	Training	Fußball	Fussball
Fussballverein	Fußball	Verein	Fussball
Fussballweltmeisterschaft	Fußball	Fussball	Weltmeisterschaft
Grossbuchstabe	gross	groß	Buchstabe
Grosseltern	Eltern	gross	groß
Grosskind	Kind	gross	groß
Grossmutter	gross	groß	Mutter
Grosssohn	gross	groß	Sohn
Grossstadt	gross	groß	Stadt
Grosstochter	gross	groß	Tochter
Grossvater	gross	groß	Vater
Sojasosse	Sauce	Soja	Sosse	Soße
Strassenkatze	Straße	Katze	Strasse
Strassennetz	Straße	Netz	Strasse
Strassenverzeichnis	Straße	Verzeichniß	Verzeichnis	Strasse
Urgrossmutter	ur-	Grossmutter	Großmutter
Urgrossvater	ur-	Großvater	Grossvater
crèmefarben	-farben	Creme	Crème
faustgross	gross	groß	Faust
grossmundig	gross	Mund	groß	-ig
