-barhet	bar	het
-ernas	er
Adelsfana	adel	fana
Alingsåsbo	Alingsås	bo
Angeredsbo	Angered	s	bo
Arjeplogsbo	Arjeplog	s	bo
Arvikabo	Arvika	bo
Avestabo	Avesta	bo
Borlängebo	Borlänge	bo
Enköpingsbo	Enköping	s	bo
Esbobo	Esbo	bo
Falköpingsbo	Falköping	s	bo
Helsingborgsbo	Helsingborg	s	bo
Jakobstadsbo	Jakobstad	bo
Landskronabo	Landskrona	bo
Lyckselebo	Lycksele	bo
Norrköping	norr	köping
Nykarlebybo	Nykarleby	bo
Närpesbo	Närpes	bo
Sverigefinal	Sverige
abortera	abort	era
abortförbud	abort	förbud
abortlagstiftning	abort	lagstiftning
absoluthet	absolut	het
absolutist	absolut	ist
absurdism	absurd	ism
acceptabelt	acceptabel	t
acceptera	accept	era
ackordera	ackord	era
adelsbrev	adel	s	brev
adelskalender	adel	kalender
adjektivform	adjektiv	form
adjektivfras	adjektiv	fras
adlighet	adlig	het
administrationsbyggnad	administration	s	byggnad
administrationsgränssnitt	administration	s	gränssnitt
administrativt	administrativ	t
adoptionsförmedling	adoption	s	förmedling
adoptionsförälder	adoption	s	förälder
adoptionsutredning	adoption	s	utredning
adressera	adress	era
adressändring	adress	ändring
adventist	advent	ist
advokatbyrå	advokat	byrå
advokatsamfund	advokat	samfund
affischera	affisch	era
affärsbank	affär	s	bank
affärsbeslut	affär	s	beslut
affärsbyggnad	affär	s	byggnad
affärsjuridiskt	affärsjuridisk	t
affärsman	affär	man
affärsmodell	affär
affärsplan	affär	s	plan
afrikanisera	afrikan	isera
aftonsång	afton	sång
akademiskt	akademisk	t
aktbilaga	akt	bilaga
aktieanalytiker	aktie	analytiker
aktiebolag	aktie	bolag
aktiebolagsägare	aktiebolag	s	ägare
aktiekapital	aktie	kapital
aktielägenhet	aktie	lägenhet
aktiemarknad	aktie	marknad
aktiemäklare	aktie	mäklare
aktieutdelning	aktie	utdelning
aktionsgrupp	aktion	s	grupp
aktivering	aktivera	ing
aktivism	aktiv	ism
aktivist	aktiv	ist
aktivitetsrapportera	aktivitetsrapport	era
aktning	akta	ning
aktsam	akt	sam
akustiker	akustik	er
akutkirurgi	akut	kirurgi
alarmera	alarm	era
alarmism	alarm	ism
alfabetisera	alfabet	isera
algodling	alg	odling
algolog	alg	log
alkoholdebut	alkohol	debut
alkoholforskare	alkohol	forskare
alkoholfri	alkohol	fri
alkoholförgiftning	alkohol	förgiftning
alkoholförsäljning	alkohol	försäljning
alkoholhaltig	alkoholhalt	ig
alkoholhandläggare	alkohol	handläggare
alkoholism	alkohol	ism
alkoholist	alkohol	ist
alkoholkonsumtion	alkohol	konsumtion
alkoholkultur	alkohol	kultur
alkohollagstiftning	alkohol	lagstiftning
alkoholmissbrukare	alkohol	missbrukare
alkoholpolitik	alkohol	politik
alkoholproblem	alkohol	problem
alkoholreform	alkohol	reform
alkoholskada	alkohol	skada
allergikonsulent	allergi	konsulent
allmänbildning	allmänbilda	ning
allmänhet	allmän	het
allmänmedicinsk	allmän	medicinsk
allmänt	allmän	t
allsidighet	allsidig	het
allsång	all	sång
allvarlig	allvar	lig
allvarlighet	allvarlig	het
allvarligt	allvarlig	t
allvarsam	allvar	sam
alternativt	alternativ	t
aluminiumverk	aluminium	verk
amatörfilm	amatör	film
amatörfysiker	amatör	fysiker
amatörmässig	amatör	mässig
amatörmålare	amatör	målare
amatörpsykolog	amatör	psykolog
amatörtävling	amatör	tävling
ambassadbyggnad	ambassad	byggnad
ambassadörspost	ambassadör	s	post
ambulanssjuksköterska	ambulans	sjuksköterska
amerikanisera	amerikan	isera
ammunitionsförråd	ammunition	s	förråd
analfabetism	analfabet	ism
analysera	analys	era
analysverktyg	analys	verktyg
anamma	an	amma
anarkokommunistiskt	anarkokommunistisk	t
anbefalla	an	befalla
anbringa	an	bringa
andlig	and	lig
anfalla	an	falla
anfallare	anfalla	are
anfallsspelare	anfall	s	spelare
anfräta	an	fräta
anfäkta	an	fäkta
anföra	an	föra
anföring	anföra	ing
anförtro	an	förtro
ange	an	ge
angelägenhet	angelägen	het
angenämt	angenäm	t
angreppssätt	angrepp	s	sätt
angripa	an	gripa
angripare	angripa	are
angränsa	an	gränsa
angå	an	gå
angöra	an	göra
anhopa	an	hopa
anhålla	an	hålla
anklaga	an	klaga
anknyta	an	knyta
anknytning	anknyta	ning
ankomma	an	komma
anligga	an	ligga
anlita	an	lita
anlägga	an	lägga
anläggare	anlägga	are
anläggning	anlägga	ning
anläggningsingenjör	anläggning	s	ingenjör
anläggningsmontör	anläggning	s	montör
anlöpa	an	löpa
anmana	an	mana
anmälare	anmäla	are
anmälning	anmäla	ning
anmälningsavgift	anmälning	s	avgift
anmälningspliktig	anmälningsplikt	ig
anmälningsskyldighet	anmälning	s	skyldighet
anmälningstillfälle	anmälning	s	tillfälle
anmärka	an	märka
anmärkning	anmärka	ning
annektering	annektera	ing
annonsera	annons	era
annonsförsäljare	annons	försäljare
annonsplats	annons	plats
annotera	an	notera
annotering	annotera	ing
anonymisera	anonym	isera
anonymisering	anonymisera	ing
anordna	an	ordna
anordnare	anordna	are
anpassa	an	passa
anpassning	anpassa	ning
anpassningsförmåga	anpassning	s	förmåga
anpassningsgrupp	anpassning	s	grupp
anropa	an	ropa
anrätta	an	rätta
anrättning	anrätta	ning
ansamla	an	samla
ansamling	ansamla	ing
anse	an	se
ansiktsmålning	målning
ansjovisfilé	ansjovis	filé
anskaffa	an	skaffa
anskaffning	anskaffa	ning
ansluta	an	sluta
anslutning	ansluta	ning
anslutningsväg	anslutning	s	väg
anslå	an	slå
anspela	an	spela
anspelning	anspela	ning
anstifta	an	stifta
anstiftare	anstifta	are
anstorma	an	storma
anstormning	anstorma	ning
anstryka	an	stryka
anstränga	an	stränga
ansträngning	anstränga	ning
anställa	an	ställa
anställning	anställa	ning
anställningsform	anställning	s	form
anställningsförhållande	anställning	s	förhållande
anställningsförmån	anställning	s	förmån
anställningstrygghet	anställning	s	trygghet
anstå	an	stå
ansvara	an	svara
ansvarig	ansvar	ig
ansvarsfrihet	ansvar	s	frihet
ansvarsfullt	ansvarsfull	t
ansvarsfördelning	ansvar	s	fördelning
ansvälla	an	svälla
ansvällning	ansvälla	ning
ansätta	an	sätta
ansöka	an	söka
ansökning	ansöka	ning
ansökningstid	ansökning	s	tid
anta	an	ta
antagning	antaga	ning
antagningshandläggare	antagning	s	handläggare
anteckna	an	teckna
antikisera	antik	isera
antisocialistiskt	antisocialistisk	t
anträda	an	träda
anträffa	an	träffa
anträffbar	anträffa	bar
antyda	an	tyda
antydning	antyda	ning
antydningsvis	antydning	s	vis
antända	an	tända
anvisa	an	visa
anvisning	anvisa	ning
använda	an	vända
användare	använda	are
användarvänlighet	användarvänlig	het
användbar	använda	bar
användbarhet	användbar	het
användning	använda	ning
apelsinskal	apelsin	skal
apostrofera	apostrof	era
apoteksbolag	apotek	s	bolag
apotekschef	apotek	s	chef
apotekskedja	apotek	s	kedja
applicerbar	applicera	bar
applikationsutvecklare	applikation	s	utvecklare
applikationsutveckling	applikation	s	utveckling
applådera	applåd	era
apputvecklare	app	utvecklare
aptitlig	aptit	lig
arabiskspråkig	arabisk	språkig
arbetare	arbete	are
arbetarstadsdel	arbetare	stadsdel
arbetsam	arbeta	sam
arbetsbrist	arbete	s	brist
arbetsförmedling	arbete	s	förmedling
arbetslöshet	arbetslös	het
arbetslöshetsförsäkring	arbetslöshet	s	försäkring
arbetslöshetskassa	arbetslöshet	s	kassa
arbetsmarknadsanalytiker	arbetsmarknad	s	analytiker
arbetsmarknadsbehov	arbetsmarknad	s	behov
arbetsmarknadsdag	arbetsmarknad	s	dag
arbetsmarknadsfråga	arbetsmarknad	s	fråga
arbetsmarknadshandläggare	arbetsmarknad	s	handläggare
arbetsmarknadsinsats	arbetsmarknad	s	insats
arbetsmarknadskonsulent	arbetsmarknad	s	konsulent
arbetsmarknadsminister	arbetsmarknad	s	minister
arbetsmarknadsområde	arbetsmarknad	s	område
arbetsmarknadsorganisation	arbetsmarknad	s	organisation
arbetsmarknadspolitik	arbetsmarknad	s	politik
arbetsmarknadsprövning	arbetsmarknad	s	prövning
arbetsmarknadsutbildning	arbetsmarknad	s	utbildning
arbetsmarknadsåtgärd	arbetsmarknad	s	åtgärd
arbetsmetod	arbete	s	metod
arbetsmetodik	arbetsmetod	ik
arbetsmiljöarbete	arbetsmiljö	arbete
arbetsmiljöfråga	arbetsmiljö	fråga
arbetsmiljöstrategi	arbetsmiljö	strategi
arbetspass	arbete	pass
arbetsplats	arbete	plats
arbetstimme	arbete	s	timme
argumentera	argument	era
arkeologiskt	arkeologisk	t
arkitektexamen	arkitekt	examen
arkitektkontor	arkitekt	kontor
arkitektstudent	arkitekt	student
arkitekttävling	arkitekt	tävling
arkitekturhögskola	arkitektur	högskola
arkitekturskola	arkitektur	skola
arkivbestånd	arkiv	bestånd
arkivera	arkiv	era
arkivhandling	arkiv	handling
arkivtjänsteman	arkiv	tjänsteman
armera	arm	era
armering	armera	ing
armmuskel	arm	muskel
armprotes	arm	protes
arméchef	armé	chef
arrendatorsbostad	arrendator	s	bostad
arrestera	arrest	era
arsenikhaltig	arsenikhalt	ig
artdöd	art	död
artig	art	ig
artigt	artig	t
artikelförfattare	artikel	författare
artist	art	ist
artonhundra	arton	hundra
artonhundra-tal	artonhundra	tal
arvprins	arv
asfaltera	asfalt	era
assistansanordnare	assistans
astmasjuksköterska	astma	sjuksköterska
astmautredning	astma	utredning
asylmottagning	asyl	mottagning
atmosfär	sfär
atmosfärsvetenskap	atmosfär	s	vetenskap
atomsopa	atom	sopa
attackera	attack	era
audiologiskt	audiologisk	t
auktorisera	auktor	isera
automatisera	automat	isera
automatiskt	automatisk	t
automatvapen	automat	vapen
automatväxel	automat	växel
avannonsera	av	annonsera
avbeställa	av	beställa
avbeställning	av	beställning
avbeta	av	beta
avbetala	av	betala
avbilda	av	bilda
avbildning	avbilda	ning
avbitare	av	bit	are
avblåsa	av	blåsa
avboka	av	boka
avbokning	avboka	ning
avbrottsersättning	avbrott	s	ersättning
avbryta	av	bryta
avböja	av	böja
avböjning	avböja	ning
avdela	av	dela
avdelning	avdela	ning
avdelningsläkare	avdelning	s	läkare
avdunsta	av	dunsta
avfyrning	avfyra	ning
avge	av	ge
avgifta	av	gifta
avgiftning	avgifta	ning
avgiva	av	giva
avgränsa	av	gränsa
avgränsning	avgränsa	ning
avgränsningsproblem	avgränsning	s	problem
avgå	av	gå
avgöra	av	göra
avhandla	av	handla
avhandling	avhandla	ing
avhandlingsarbete	avhandling	s	arbete
avhjälpa	av	hjälpa
avhoppa	av	hoppa
avhoppare	avhoppa	are
avhysa	av	hysa
avhålla	av	hålla
avidentifiera	av	identifiera
avisa	av	isa
avisering	avisera	ing
avjämna	av	jämna
avkarbonisering	av
avkasta	av	kasta
avkastning	avkasta	ning
avklara	av	klara
avkoda	av	koda
avkoppla	av	koppla
avkriminalisera	av	kriminalisera
avkunna	av	kunna
avkyla	av	kyla
avlasta	av	lasta
avlastare	avlasta	are
avleda	av	leda
avledning	avleda	ning
avlida	av	lida
avliva	av	liva
avloppsledning	avlopp	s	ledning
avlossa	av	lossa
avlusa	av	lusa
avlysa	av	lysa
avlyssna	av	lyssna
avlägga	av	lägga
avläggare	avlägga	are
avlämna	av	lämna
avläsa	av	läsa
avläsning	avläsa	ning
avlöna	av	löna
avlösa	av	lösa
avmaska	av	maska
avnjuta	av	njuta
avpublicera	av	publicera
avradikalisera	av	radikalisera
avradikalisering	avradikalisera	ing
avrapportera	av	rapportera
avrapportering	avrapportera	ing
avreagera	av	reagera
avregistrera	av	registrera
avrekommendera	av	rekommendera
avrunda	av	runda
avrusta	av	rusta
avrätta	av	rätta
avrättning	avrätta	ning
avse	av	se
avsegla	av	segla
avsiktlig	avsikt	lig
avsiktligt	avsiktlig	t
avskaffa	av	skaffa
avskeda	av	skeda
avskedsbrev	avsked	s	brev
avskildhet	avskild	het
avskilja	av	skilja
avskriva	av	skriva
avskrivning	avskriva	ning
avskräckning	avskräcka	ning
avsky	av	sky
avslappningsövning	avslappning	s	övning
avsluta	av	sluta
avslutning	avsluta	ning
avslutningsvis	avslutning	s	vis
avslå	av	slå
avsmaka	av	smaka
avspegla	av	spegla
avspegling	avspegla	ing
avspisa	av	spisa
avspärra	av	spärra
avspärrning	avspärra	ning
avstanna	av	stanna
avstava	av	stava
avstavning	avstava	ning
avstyrka	av	styrka
avstå	av	stå
avsvalna	av	svalna
avsäga	av	säga
avsända	av	sända
avsändare	avsända	are
avsätta	av	sätta
avsättning	avsätta	ning
avsöndra	av	söndra
avta	av	ta
avtacka	av	tacka
avtackning	avtacka	ning
avtala	av	tala
avtalssekreterare	avtal	s	sekreterare
avteckna	av	teckna
avtjäna	av	tjäna
avträda	av	träda
avvakta	av	vakta
avvattna	av	vattna
avveckla	av	veckla
avveckling	avveckla	ing
avvecklingsplan	avveckling	s	plan
avverka	av	verka
avvika	av	vika
avvikare	avvika	are
avvinna	av	vinna
avvisa	av	visa
avvisning	avvisa	ning
avvägning	avväga	ning
avyttra	av	yttra
baddare	badda	are
badgäst	bad	gäst
badort	bad
badparasit	bad	parasit
badrum	bad	rum
badsemester	bad	semester
badstuga	bad	stuga
baffelplåt	baffel	plåt
bagatellisera	bagatell	isera
bajskorv	bajs	korv
bakgrundsbild	bakgrund	s	bild
bakgård	bak	gård
bakning	baka	ning
bakplåtspapper	bakplåt	s	papper
bakpå	bak	på
balansakt	balans	akt
balansera	balans	era
balansräkning	balans	räkning
balettkjol	balett	kjol
balkongdörr	balkong	dörr
balkongdörrhållare	balkongdörr	hållare
balsamering	balsamera	ing
bananskal	banan	skal
bancykel	bana	cykel
bandspelare	band	spelare
bandyklubb	bandy
bankdag	bank	dag
bankkonto	bank	konto
bankkvinna	bank	kvinna
banklån	bank	lån
bantning	banta	ning
barmhärtighet	barmhärtig	het
barmhärtigt	barmhärtig	t
barnarbetare	barn	arbetare
barnavdelning	barn	avdelning
barnbibliotekarie	barn	bibliotekarie
barnbidrag	barn	bidrag
barnbiljett	barn	biljett
barnbok	barn	bok
barnboksförfattare	barnbok	s	författare
barnboksförfattarinna	barnbok	s	författarinna
barnboksförläggare	barnbok	s	förläggare
barnboksillustratör	barnbok	s	illustratör
barncykel	barn	cykel
barndomshem	barndom	s	hem
barndomskamrat	barndom	s	kamrat
barndomskompis	barndom	s	kompis
barndomsperiod	barndom	s	period
barndomsvän	barndom	s	vän
barnfamilj	barn	familj
barnfetma	barn	fetma
barnflicka	barn	flicka
barnfri	barn	fri
barnhem	barn	hem
barnjungfru	barn	jungfru
barnkalas	barn	kalas
barnkonvention	barn	konvention
barnlitteratur	barn	litteratur
barnläkare	barn	läkare
barnläkarmottagning	barn	läkarmottagning
barnlös	barn	lös
barnlöshet	barnlös	het
barnmisshandel	barn	misshandel
barnmottagning	barn	mottagning
barnneurolog	barn	neurolog
barnombudsman	barn	ombudsman
barnomsorg	barn	omsorg
barnomsorgsavgift	barnomsorg	s	avgift
barnpsykiatri	barn	psykiatri
barnpsykolog	barn	psykolog
barnreumatolog	barn	reumatolog
barnserie	barn
barnsjukdom	barn	sjukdom
barnsjukhus	barn	sjukhus
barnsjuksköterska	barn	sjuksköterska
barnskola	barn	skola
barnskötare	barn	skötare
barnsköterska	barn	sköterska
barnslighet	barnslig	het
barnsligt	barnslig	t
barnsoldat	barn	soldat
barnspråk	barn	språk
barnstuga	barn	stuga
barnsäng	barn	säng
barntidning	barn	tidning
barnträdgård	barn	trädgård
barnträdgårdslärarinna	barnträdgård	s	lärarinna
barnvagn	barn	vagn
barnvakt	barn	vakt
barnäktenskap	barn	äktenskap
barnäktenskapsbrott	barnäktenskap	s	brott
barnäktenskapsresa	barnäktenskap	s	resa
barrikadera	barrikad	era
barrskogsregion	barrskog	s	region
basketliga	basket	liga
basunera	basun	era
batterifabrik	batteri	fabrik
batteriholk	batteri	holk
batteritillverkare	batteri	tillverkare
bearbetning	bearbeta	ning
bearbetningsbar	bearbetning	s	bar
bearbetningsmaskin	bearbetning	s	maskin
becknarväska	becknare	väska
bedragare	bedraga	are
bedrägligt	bedräglig	t
bedömare	bedöma	are
bedömning	bedöma	ning
bedömningssvårighet	bedömning	s	svårighet
bedövning	bedöva	ning
befallning	befalla	ning
befattningsutbildning	befattning	s	utbildning
befintlighet	befintlig	het
befolkning	befolka	ning
befolkningsgrupp	befolkning	s	grupp
befolkningsökning	befolkning	s	ökning
befordring	befordra	ing
befrielserörelse	befrielse	rörelse
befruktning	befrukta	ning
befrämjare	befrämja	are
befälselev	befäl	s	elev
befästning	befästa	ning
begeistring	begeistra	ing
begravning	begrava	ning
begravningsbyrå	begravning	s	byrå
begravningskyrka	begravning	s	kyrka
begränsning	begränsa	ning
begärlig	begär	lig
behaglig	behag	lig
behandlare	behandla	are
behandling	behandla	ing
behandlingshem	behandling	s	hem
behandlingsinstitution	behandling	s	institution
behandlingsprotokoll	behandling	s	protokoll
behandlingssamarbete	behandling	s	samarbete
behållare	behålla	are
behållning	behålla	ning
behålös	behå	lös
behörighet	behörig	het
bekostnad	bekosta	nad
bekymmersam	bekymmer	sam
bekymmersfrihet	bekymmersfri	het
bekämpning	bekämpa	ning
bekännelseroman	bekännelse	roman
belastning	belasta	ning
belastningsproblem	belastning	s	problem
belastningsprov	belastning	s	prov
belysning	belysa	ning
belägenhet	belägen	het
beläggning	belägga	ning
beläggningsarbetare	beläggning	s	arbetare
belägring	belägra	ing
bemanningsbransch	bemanning	s	bransch
bemanningsföretag	bemanning	s	företag
bemanningskonsult	bemanning	s	konsult
bemanningsuppdrag	bemanning	s	uppdrag
benfri	ben	fri
benlös	ben	lös
bensinmack	bensin	mack
bensinmotor	bensin	motor
benskörhet	ben
benägenhet	benägen	het
beredning	bereda	ning
beredskapsläge	beredskap	s	läge
bergart	berg	art
bergig	berg	ig
beroendeställning	beroende	ställning
berusning	berusa	ning
berättare	berätta	are
berömdhet	berömd	het
berömlig	beröm	lig
besittning	besitta	ning
beskattning	beskatta	ning
beskattningsår	beskattning	s	år
beskjutning	beskjuta	ning
beskrivning	beskriva	ning
beskyddare	beskydda	are
beskyllning	beskylla	ning
beslutsam	beslut	sam
beslutsordning	beslut	s	ordning
besläktad	be	släkt
besprutning	bespruta	ning
bestraffning	bestraffa	ning
beställare	beställa	are
beställning	beställa	ning
beställningsuppdrag	beställning	s	uppdrag
beständighet	beständig	het
besvärlig	besvär	lig
besvärlighet	besvärlig	het
besvärligt	besvärlig	t
besättning	besätta	ning
besökare	besöka	are
besöksadress	besök	s	adress
besöksförbud	besök	s	förbud
betalare	betala	are
betalning	betala	ning
betalningsupplevelse	betalning	s	upplevelse
beteendedesign	beteende	design
beteendeflexibilitet	beteende	flexibilitet
beteendeforskare	beteende	forskare
beteendeförändring	beteende	förändring
beteendemässig	beteende	mässig
beteendemönster	beteende	mönster
beteendepåverkan	beteende	påverkan
beteenderubbning	beteende	rubbning
beteendestrateg	beteende	strateg
beteendeterapi	beteende	terapi
beteendevetenskap	beteende	vetenskap
betning	beta	ning
betongarbetare	betong	arbetare
betongbyggnad	betong	byggnad
betongförort	betong	förort
betongingenjör	betong	ingenjör
betongtrappa	betong	trappa
betongvilla	betong	villa
betongvägg	betong	vägg
betraktare	betrakta	are
betydelsemässig	betydelse	mässig
betydelsenyans	betydelse	nyans
betydelseskillnad	betydelse	skillnad
betydelseutveckling	betydelse	utveckling
betydligt	betydlig	t
betäckning	betäcka	ning
beundrare	beundra	are
bevakning	bevaka	ning
bevakningsföretag	bevakning	s	företag
bevakningstjänst	bevakning	s	tjänst
bevisning	bevisa	ning
bevisvärdering	bevis	värdering
bibehålla	bi	behålla
bibetydelse	bi	betydelse
biblioteksersättning	bibliotek	s	ersättning
biblioteksförening	bibliotek	s	förening
bibliotekskatalog	bibliotek	s	katalog
bibliotekskonsulent	bibliotek	s	konsulent
bibliotekskort	bibliotek	s	kort
biblioteksväsen	bibliotek	s	väsen
bidragsfuskare	bidrag	s	fuskare
bieffekt	bi	effekt
biffstek	biff	stek
biflöde	bi	flöde
biflödesordning	biflöde	ordning
bilbatteri	bil	batteri
bilbatterifabrik	bilbatteri	fabrik
bilbesiktning	bil	besiktning
bilbomb	bil	bomb
bilbrand	bil	brand
bildanalys	bild	analys
bildkonstnär	bild	konstnär
bildmaterial	bild	material
bildmässig	bild	mässig
bildning	bilda	ning
bildspråk	bild	språk
bildtelefon	bild	telefon
bildterapi	bild	terapi
bildtext	bild	text
bildörr	bil	dörr
bildöverföring	bild	överföring
bilfabrik	bil	fabrik
bilfri	bil	fri
bilfärja	bil	färja
bilförare	bil	förare
bilföretag	bil	företag
bilförsäkring	bil	försäkring
bilförsäkringsbolag	bilförsäkring	s	bolag
bilförsäljare	bil	försäljare
bilhandlare	bil	handlare
bilism	bil	ism
bilist	bil	ist
biljettförsäljning	biljett	försäljning
biljettkiosk	biljett	kiosk
billig	bill	ig
bilmekaniker	bil	mekaniker
bilmontör	bil	montör
bilmärke	bil	märke
bilmässa	bil	mässa
bilolycka	bil	olycka
bilparkering	bil	parkering
bilpendlare	bil	pendlare
bilpool	bil	pool
bilreparatör	bil	reparatör
bilresa	bil	resa
bilsemester	bil	semester
biltillverkare	bil	tillverkare
biltillverkning	bil	tillverkning
biltrafik	bil	trafik
biltävling	bil	tävling
bilutställning	bil	utställning
bilverkstad	bil	verkstad
bilägare	bil	ägare
bindning	binda	ning
biobränsle	bio	bränsle
biodynamiskt	biodynamisk	t
biofilm	bio	film
biogasanläggning	biogas	anläggning
biologilärare	biologi	lärare
biometriskt	biometrisk	t
biopsykosocialt	biopsykosocial	t
bisatsordföljd	bisats	ordföljd
biseksualitet	sexualitet	bi-
biskopssäte	biskop	s	säte
biståndsarbetare	bistånd	s	arbetare
biståndsinsats	bistånd	insats
biståndsmyndighet	bistånd	s	myndighet
biståndsorganisation	bistånd	s	organisation
bitterhet	bitter	het
bitvis	bit	vis
bjudning	bjuda	ning
björknäver	björk	näver
blandning	blanda	ning
blankare	blanka	are
blankning	blanka	ning
blankningsposition	blankning
blasonering	blasonera	ing
blindhet	blind	het
blinkning	blinka	ning
blockera	block	era
blockkedja	block	kedja
blodflöde	blod	flöde
blodig	blod	ig
blodkorv	blod	korv
blodsjukdom	blod	sjukdom
blodsocker	blod	socker
blodsockernivå	blodsocker	nivå
bloggare	blogga	are
blogginlägg	blogg	inlägg
bloggtävling	blogg	tävling
bluffmakare	bluff	makare
blyghet	blyg	het
blykärna	bly	kärna
bläckfisk	bläck	fisk
bläckflaska	bläck	flaska
blänkare	blänka	are
blåljus	blå	ljus
blåljuspersonal	blåljus	personal
blåsare	blåsa	are
blåsigt	blåsig	t
blödning	blöda	ning
bogserare	bogsera	are
bogsering	bogsera	ing
bokföring	bokföra	ing
bokstavera	bokstav	era
bolagsform	bolag	s	form
bolagsjurist	bolag	s	jurist
bolagsstyrelse	bolag	s	styrelse
bolagsstämma	bolag	s	stämma
bolare	bola	are
bombkrater	bomb	krater
bombning	bomba	ning
bondebefolkning	bonde	befolkning
bonusmamma	bonus	mamma
borgare	borga	are
borrkärna	borr	kärna
borrmaskin	borr	maskin
borrtekniker	borr	tekniker
bortförklaring	bortförklara	ing
bostadsadress	bostad	s	adress
bostadsaktiebolag	bostad	s	aktiebolag
bostadsanpassning	bostad	s	anpassning
bostadsbidrag	bostad	s	bidrag
bostadsbolag	bostad	s	bolag
bostadsbrist	bostad	s	brist
bostadsbyggnad	bostad	s	byggnad
bostadsersättning	bostad	s	ersättning
bostadsföretag	bostad	s	företag
bostadsförmedling	bostad	s	förmedling
bostadshus	bostad	s	hus
bostadskö	bostad	s	kö
bostadslägenhet	bostad	s	lägenhet
bostadsmarknad	bostad	s	marknad
bostadsminister	bostad	s	minister
bostadsområde	bostad	s	område
bostadsort	bostad	s	ort
bostadspolitik	bostad	s	politik
bostadsrättsavgift	bostadsrätt	s	avgift
bostadsrättsförening	bostadsrätt	s	förening
bostadsrättsinnehavare	bostadsrätt	s	innehavare
bostadsrättslägenhet	bostadsrätt	s	lägenhet
bostadssäljare	bostad	s	säljare
bostadstillägg	bostad	s	tillägg
bostadsyta	bostad	s	yta
bosättning	bosätta	ning
bosättningsområde	bosättning	s	område
bottenlös	botten	lös
bottenvikt	botten	vikt
bovetemjöl	bovete	mjöl
boxare	boxa	are
boxning	boxa	ning
brandinspektion	brand	inspektion
brandkår	brand	kår
brandman	brand	man
brandskydd	brand	skydd
brandsäkerhet	brand	säkerhet
brandvägg	brand	vägg
branschföreträdare	bransch	företrädare
branschjurist	bransch	jurist
bredband	bred	band
breddning	bredda	ning
bredsladd	bred	sladd
brevbärare	brev	bärare
brevhemlighet	brev	hemlighet
brevhuvud	brev	huvud
brevkniv	brev	kniv
brevlåda	brev	låda
brevlådeföretag	brevlåda	företag
brevröstning	brevrösta	ning
brevväxling	brev	växling
brevvåg	brev	våg
brigadgeneral	brigad	general
bristning	brista	ning
brofundament	bro	fundament
bromsklots	broms	klots
bromsmedicin	broms	medicin
bromsning	bromsa	ning
broskig	brosk	ig
brottslighet	brottslig	het
broöppning	bro	öppning
brukare	bruka	are
brukshund	bruka	hund
bruksvara	bruk	vara
bryggeriarbetare	bryggeri	arbetare
brytare	bryta	are
brytning	bryta	ning
bränslesystem	bränsle	system
bråkning	bråka	ning
brödig	bröd	ig
brödkniv	bröd	kniv
brödkorg	bröd	korg
brödlimpa	bröd	limpa
brödskiva	bröd	skiva
bröllopsdag	bröllop	s	dag
bröllopsgåva	bröllop	s	gåva
bröllopskyrka	bröllop	s	kyrka
bröllopsmarsch	bröllop	s	marsch
bröllopsnatt	bröllop	s	natt
bröstregister	bröst	register
budbil	bud	bil
budbilsförare	budbil	s	förare
budgetera	budget	era
budgetomröstning	budget	omröstning
budgetram	budget	ram
budord	bud	ord
budröstning	budrösta	ning
buggrapport	bugg	rapport
bugning	buga	ning
buksvåger	buk	svåger
bulgariskspråkig	bulgarisk	språkig
buljongtärning	buljong	tärning
bullfitta	bulle	fitta
bussbiljett	buss	biljett
busschaufför	buss	chaufför
bussförare	buss	förare
busshållplats	buss	hållplats
bussning	bussa	ning
bussresa	buss	resa
busstrafik	buss	trafik
butikschef	butik	s	chef
butikskommunikatör	butik	s	kommunikatör
byggare	bygga	are
bygglovshandläggare	bygglov	s	handläggare
byggnad	bygga	nad
byggnadsantikvarie	byggnad	s	antikvarie
byggnadsarbetare	byggnad	s	arbetare
byggnadshistoriskt	byggnadshistorisk	t
byggnadskonstruktör	byggnad	s	konstruktör
byggnadsprojekt	byggnad	s	projekt
byggnadsteknisk	byggnad
byggnadstyp	byggnad	s	typ
byrådirektör	byrå	direktör
bärare	bära	are
bärgare	bärga	are
bärgning	bärga	ning
bärmust	bär	must
bärplockare	bär	plockare
bättring	bättra	ing
båthus	båt	hus
båtresa	båt	resa
böjare	böja	are
böjning	böja	ning
bördig	börd	ig
bördighet	bördig	het
börsnotering	börsnotera	ing
cafébiträde	café	biträde
campingplats	camping	plats
campuskurs	campus	kurs
campusområde	campus	område
cancelkultur	cancel	kultur
cancerforskning	cancer	forskning
cancerpatient	cancer	patient
cancertumör	cancer	tumör
cellist	cell	ist
censurera	censur	era
centralbyggnad	central	byggnad
centralenhet	central	enhet
centralisering	centralisera	ing
ceremonimästare	ceremoni	mästare
chanslös	chans	lös
chansning	chansa	ning
chefredaktör	chef	redaktör
chefsansvar	chef	ansvar
chefssjuksköterska	chef	s	sjuksköterska
chilifrukt	chili	frukt
chilisås	chili	sås
chipspåse	chips	påse
chockbehandla	chock	behandla
chockera	chock	era
chokladbakelse	choklad	bakelse
chokladbrun	brun
chokladmjölk	choklad	mjölk
chokladpralin	choklad	pralin
chokladsås	choklad	sås
chokladtårta	choklad	tårta
cigarettfimp	cigarett	fimp
cigarettpaket	cigarett	paket
cigarettrök	cigarett	rök
cigarrettrullningsmaskin	cigarrett	rullning	maskin
cirkapris	cirka	pris
cirkulent	konsument	cirkulär
cirkusapa	cirkus	apa
citationstecken	citation	s	tecken
citattecken	citat	tecken
citrongul	citron	gul
citronklyfta	citron	klyfta
citronolja	citron	olja
citrusklyfta	citrus	klyfta
civilekonomexamen	civilekonom	examen
civilingenjörsutbildning	civilingenjör	s	utbildning
civilisationssjukdom	civilisation	s	sjukdom
civilisera	civil	isera
civilist	civil	ist
clownnäsa	clown	näsa
coachning	coach
containerfartyg	container	fartyg
coolt	cool	t
coronaanpassa	corona	anpassa
coronabubbla	corona	bubbla
coronaersättning	corona	ersättning
coronahund	corona	hund
coronahälsning	corona	hälsning
coronapandemi	corona	pandemi
coronavirus	corona	virus
crowdfunding	crowdfunda	ing
cyberincident	cyber	incident
cyberkris	cyber	kris
cyberområde	cyber	område
cybersoldat	cyber
cybersäkerhet	cyber	säkerhet
cybersäkerhetskrav	cyber	säkerhetskrav
cybersäkerhetsnivå	cyber	säkerhetsnivå
cybersäkerhetsskyldighet	cybersäkerhet	s	skyldighet
cybersäkerhetsåtgärd	cyber	säkerhetsåtgärd
cykelbana	cykel	bana
cykeldåre	cykel	dåre
cykelhandlare	cykel	handlare
cykelhjul	cykel	hjul
cykelhjälm	cykel	hjälm
cykelkedja	cykel	kedja
cykelkorg	cykel	korg
cykellås	cykel	lås
cykelresa	cykel	resa
cykelsemester	cykel	semester
cykeltur	cykel	tur
cykelverkstad	cykel	verkstad
cykelväg	cykel	väg
cykelöverfart	cykel	överfart
cykling	cykla	ing
cyklist	cykel	ist
dagdrömmare	dagdrömma	are
dagersättning	dag	ersättning
daggkåpa	dagg	kåpa
dagisbarn	dagis	barn
dagisplats	dagis	plats
daglig	dag	lig
dagsläge	dag	s	läge
dajmkryss	dajm	kryss
dammråtta	damm	råtta
dammsugare	dammsuga	are
dansare	dansa	are
dansgrupp	dans	grupp
danshögskola	dans	högskola
danskonst	dans	konst
danskspråkig	dansk	språkig
danspedagog	dans	pedagog
dansutbildning	dans	utbildning
darrning	darra	ning
databasadministratör	databas	administratör
databehandling	databehandla	ing
datakvalitet	data	kvalitet
datasystem	data	system
datavetenskaplig	datavetenskap	lig
datering	datera	ing
datorbord	dator	bord
datorhall	dator	hall
datorlingvistik	dator	lingvistik
datormiljö	dator	miljö
datornätverk	dator	nätverk
datorskärm	skärm	dator	-s-
datorspel	dator	spel
datorsystem	dator	system
datortillverkare	dator	tillverkare
datorväska	dator	väska
debattera	debatt	era
debattinlägg	debatt	inlägg
debattmotståndare	debatt	motståndare
debutera	debut	era
debutroman	debut	roman
decentralisering	decentralisera	ing
definitivt	definitiv	t
degbunke	deg	bunke
degig	deg	ig
degvätska	deg	vätska
deklarationsblankett	deklaration	s	blankett
dekorativt	dekorativ	t
delaktighet	delaktig	het
delbar	dela	bar
delegering	delegera	ing
delfinansiering	delfinansiera	ing
delgivning	delgiva	ning
delikatessdisk	delikatess	disk
delning	dela	ning
delningsboende	delning	boende
delområde	del	område
delstat	del	stat
deltagare	deltaga	are
delvis	del	vis
demografiskt	demografisk	t
demojury	demo
demojurymöte	demojury
demokratiskt	demokratisk	t
demonstrationsanläggning	demonstration	s	anläggning
demontering	demontera	ing
designhögskola	design	högskola
designmässig	design	mässig
dessertsked	dessert	sked
desserttallrik	dessert	tallrik
detaljist	detalj	ist
detentionsrätt	detention	rätt
diabetessjuksköterska	diabetes	sjuksköterska
diagnosgrupp	diagnos	grupp
diagnoskriterie	diagnos
diagonalt	diagonal	t
dialektalt	dialektal	t
dialektarkiv	dialekt	arkiv
dialektforskning	dialekt	forskning
dialektolog	dialekt	o	log
diamantbröllop	diamant	bröllop
dieselbil	diesel	bil
dietist	diet	ist
digitalisera	digital	isera
digitalisering	digitalisera	ing
digitalkamera	digital	kamera
diktare	dikta	are
diktera	dikt	era
diktning	dikta	ning
disciplinnämnd	disciplin	nämnd
diskare	diska	are
diskmaskin	disk	maskin
diskriminering	diskriminera	ing
diskrimineringslagstiftning	diskriminering	s	lagstiftning
distansera	distans	era
distriktskyrka	distrikt	s	kyrka
distriktsläkare	distrikt	s	läkare
distriktssköterskemottagning	distriktssköterska	mottagning
djupintervju	djup	intervju
djupt	djup	t
djurkommunikatör	djur	kommunikatör
djursjukdom	djur	sjukdom
djursjukhus	djur	sjukhus
djurskötare	djur	skötare
djurvårdare	djur	vårdare
doktorandtjänst	doktorand	tjänst
doktorera	doktor	era
doktorshatt	doktor	s	hatt
dokumentationskrav	dokumentation	s	krav
dokumentera	dokument	era
dokumentsamling	dokument	samling
donera	don	era
dopning	dopa	ning
dopping	doppa	ing
dosera	dos	era
dosering	dosera	ing
dotterföretag	dotter	företag
doulautbildning	doula	utbildning
dragbil	drag	bil
drejare	dreja	are
driftig	drift	ig
drifttekniker	drift	tekniker
drivmedel	driva	medel
drivmedelsskatt	drivmedel	s	skatt
drogbehandlare	drog	behandlare
drogterapeut	drog	terapeut
drygt	dryg	t
dränera	drän	era
drömjobb	dröm	jobb
drömkvinna	dröm	kvinna
drömmare	drömma	are
dubbdäck	dubb	däck
dubbelkedja	dubbel	kedja
dubbelspråkig	dubbel	språkig
dubbelspårig	dubbelspår	ig
dubbelsyn	dubbel
dubbelt	dubbel	t
duellera	duell	era
dukning	duka	ning
dumhet	dum	het
dumpning	dumpa	ning
duvblå	duva	blå
duvgrön	duva	grön
dvs	vilja	det	säga
dygdig	dygd	ig
dykare	dyka	are
dykning	dyka	ning
dyrkare	dyrka	are
dämpning	dämpa	ning
dålighet	dålig	het
dåligt	dålig	t
döding	döda	ing
dödlig	död	lig
dödlighet	dödlig	het
dödligt	dödlig	t
dödsfall	död	s	fall
dödshetta	död	s	hetta
effektbrytare	effekt	brytare
effektivisera	effektiv	isera
effektivisering	effektivisera	ing
effektutvärdering	effekt	utvärdering
efterapare	efterapa	are
efterlevnad	efterleva	nad
efterlysning	efterlysa	ning
efternamn	efter	namn
eftersom	efter	som
eftersökning	eftersöka	ning
eftertanke	efter	tanke
efterträdare	efterträda	are
egendomlig	egendom	lig
egendomlighet	egendomlig	het
egenkär	egen	kär
egensinnigt	egensinnig	t
ekdörr	ek	dörr
ekipering	ekipera	ing
ekivokt	ekivok	t
ekonomiavdelning	ekonomi	avdelning
ekonomiskt	ekonomisk	t
ekonomistudent	ekonomi	student
ekskog	ek	skog
elbil	el	bil
elbilist	elbil	ist
elbilsbatteri	elbil	s	batteri
elbilsbrand	elbil	s	brand
elbilsförare	elbil	s	förare
elbilsladdare	elbil	s	laddare
elbrist	el	brist
eldare	elda	are
eldsläckare	eld	släckare
elektricitetsverk	elektricitet	s	verk
elektrifiering	elektrifiera	ing
elektronikmontör	elektronik	montör
elevassistent	elev	assistent
elevavgift	elev	avgift
elevhem	elev	hem
elevmatsal	elev	matsal
elevombud	elev	ombud
elevregister	elev	register
elevunderlag	elev	underlag
elfordon	el	fordon
elgräsklippare	el	gräsklippare
elitseriemässig	elitserie	mässig
elitsoldat	elit	soldat
elkund	el	kund
ellastbil	el	lastbil
elledning	el	ledning
elleverantör	el	leverantör
elmarknad	el	marknad
elproduktion	el	produktion
elverk	el	verk
emaljera	emalj	era
emaljerare	emaljera	are
empiriskt	empirisk	t
energidryck	energi	dryck
energieffektiv	energi
energiförbrukning	energi	förbrukning
energiförsörjning	energi	försörjning
energikälla	energi	källa
energilös	energi	lös
energiomsättning	energi	omsättning
engelskspråkig	engelsk	språkig
engångs-	en	gång	s
engångskostnad	engångs	kostnad
engångsligg	engångs	ligg
enhetlig	enhet	lig
enhetslast	enhet	s	last
enkelhet	enkel	het
enkelspårig	enkelspår	ig
enkelt	enkel	t
enormt	enorm	t
ensamhet	ensam	het
enskildhet	enskild	het
enspråkighet	enspråkig	het
epadunk	dunk
erfarenhet	erfaren	het
erinring	erinra	ing
ersättare	ersätta	are
ersättning	ersätta	ning
ersättningsprodukt	ersättning	s	produkt
erövring	erövra	ing
eskimåspråk	eskimå	språk
eskortera	eskort	era
essäistiskt	essäistisk	t
etablering	etablera	ing
etableringsstöd	etablering	s	stöd
etappvis	etapp	vis
etniskt	etnisk	t
etymologiskt	etymologisk	t
evakuering	evakuera	ing
eventuellt	eventuell	t
evighet	evig	het
exakthet	exakt	het
examensuppsats	examen	s	uppsats
exempellös	exempel	lös
exempelvis	exempel	vis
exotiskt	exotisk	t
experimentera	experiment	era
expertgrupp	expert	grupp
expertkunskap	expert	kunskap
expertuppdrag	expert	uppdrag
expertutlåtande	expert	utlåtande
exploatering	exploatera	ing
exponering	exponera	ing
exportera	export	era
exportföretag	export	företag
expressivt	expressiv	t
externt	extern	t
extremism	extrem	ism
extremist	extrem	ist
extremt	extrem	t
fabriksarbetare	fabrik	s	arbetare
fabriksbutik	fabrik	s	butik
fabulering	fabulera	ing
fackföreningsavgift	fackförening	s	avgift
fackföreningsledare	fackförening	s	ledare
facklig	fack	lig
fackmässig	fack	mässig
fackspråk	fack	språk
faktafel	faktum	fel
faktiskhet	faktisk	het
faktiskt	faktisk	t
faktoranalys	faktor	analys
fakturaavgift	faktura	avgift
fakturabetalning	faktura	betalning
fakultetsstyrelse	fakultet	s	styrelse
fallbeskrivning	fall	beskrivning
fallera	fall	era
fallskärm	fall	skärm
familjebostad	familj	e	bostad
familjedaghem	familj	e	daghem
familjeekonom	familj	e	ekonom
familjehemsplacera	familjehem	s	placera
familjehemssekreterare	familjehem	s	sekreterare
familjeläkare	familj	e	läkare
fantastiskt	fantastisk	t
farlig	far	lig
farmoder	far	moder
farthållare	fart	hållare
fartygslämning	fartyg
fartygsregister	fartyg	s	register
fastemånad	fasta	månad
fastighetsaffär	fastighet	s	affär
fastighetsbeteckning	fastighet	s	beteckning
fastighetsbolag	fastighet	s	bolag
fastighetsförmedling	fastighet	s	förmedling
fastighetskontor	fastighet	s	kontor
fastighetspris	fastighet	s	pris
fastighetsutvecklare	fastighet	s	utvecklare
fastighetsverk	fastighet	s	verk
fastighetsägare	fastighet	s	ägare
febersymptom	feber	symptom
felaktighet	felaktig	het
felaktigt	felaktig	t
felcitera	fel	citera
felmarginal	fel	marginal
felparkering	felparkera	ing
femprocentig	fem	procentig
festlig	fest	lig
festlighet	festlig	het
fettdepå	fett
fientlighet	fientlig	het
figurera	figur	era
fikabord	fika	bord
fikabröd	fika	bröd
fikarum	fika	rum
filmarbetare	film	arbetare
filmare	filma	are
filmbolag	film	bolag
filmfestival	film	festival
filmfotograf	film	fotograf
filmframkallning	film	framkallning
filmförevisning	film	förevisning
filmgranskning	film	granskning
filmhistoria	film	historia
filmhögskola	film	högskola
filminspelning	film	inspelning
filmkamera	film	kamera
filmklipp	film	klipp
filmklippare	film	klippare
filmkomedi	film	komedi
filmkompositör	film	kompositör
filmkritiker	film	kritiker
filmmedie	film
filmmässig	film	mässig
filmpremiär	film	premiär
filmprojekt	film	projekt
filmrecensent	film	recensent
filmregissör	film	regissör
filmremsa	film	remsa
filmrulle	film	rulle
filmsekvens	film	sekvens
filmskapare	film	skapare
filmskola	film	skola
filmskådespelare	film	skådespelare
filmstjärna	film	stjärna
filmstudent	film	student
filmtecknare	film	tecknare
filmtekniker	film	tekniker
filmtidskrift	film	tidskrift
filmvetare	film	vetare
filmvetenskap	film	vetenskap
filmvisning	film	visning
filosofiprofessor	filosofi	professor
filosofistudent	filosofi	student
filterbubbla	filter	bubbla
filékniv	filé	kniv
fimpare	fimpa	are
finalist	final	ist
finansiering	finansiera	ing
finanspolitik	politik
fingersättning	finger	sättning
finskfödd	finsk	född
finskhet	finsk	het
finskspråkig	finsk	språkig
finskspråkighet	finskspråkig	het
fiskare	fisk	are
fiskbil	fisk	bil
fiskbilsförare	fiskbil	s	förare
fiskbuljong	fisk	buljong
fiskeläge	fiske	läge
fiskfilé	fisk	filé
fiskgryta	fisk	gryta
fiskhandlare	fisk	handlare
fiskkniv	fisk	kniv
fiskmjöl	fisk	mjöl
fiskodlare	fisk	odlare
fiskpedikyr	fisk	pedikyr
fiskpinne	fisk	pinne
fisksoppa	fisk	soppa
fisksås	fisk	sås
fittsmisk	fitta	smisk
fixering	fixera	ing
fjantig	fjant	ig
fjäderlös	fjäder	lös
fjädring	fjädra	ing
fjällig	fjäll	ig
fjällområde	fjäll	område
fjällturist	fjäll	turist
fjällvandrare	fjällvandra	are
flakmoped	flak	moped
flaktankning	flak
flamsig	flams	ig
flerspråkig	fler	språkig
flerspråkighet	flerspråkig	het
flicknamn	flicka	namn
flitig	flit	ig
flitigt	flitig	t
flottare	flotta	are
flottning	flotta	ning
fluorera	fluor	era
flygare	flyga	are
flygbolag	flyg	bolag
flygledare	flyg	ledare
flyglinje	flyg	linje
flygmaskin	flyg	maskin
flygning	flyga	ning
flygplatschef	flygplats	chef
flygskam	flyg	skam
flygskatt	flyg	skatt
flykting	flykta	ing
flyktingbarn	flykting	barn
flyktingflicka	flykting	flicka
flyktingförläggning	flykting	förläggning
flyktingkris	flykting	kris
flyktingkvinna	flykting	kvinna
flyktingläger	flykting	läger
flyktingmottagning	flykting	mottagning
flyktingpojke	flykting	pojke
flyktingskris	flykting	kris
flytning	flyta	ning
flyttning	flytta	ning
fläckfri	fläck	fri
fläckvis	fläck	vis
fläskfilé	fläsk	filé
fläskkorv	fläsk	korv
fläskkotlett	fläsk	kotlett
fläskkött	fläsk	kött
fläskläpp	fläsk	läpp
flörtig	flört	ig
fnasig	fnas	ig
fokusera	fokus	era
folkbibliotek	folk	bibliotek
folkbokföring	folk	bokföring
folkbokföringsadress	folkbokföring	s	adress
folkbokföringsbrott	folkbokföring	s	brott
folkbokföringsmyndighet	folkbokföring	s	myndighet
folkbokföringsnummer	folkbokföring	s	nummer
folkbokföringsregister	folkbokföring	s	register
folkbåt	folk	båt
folkdikt	folk	dikt
folkdräkt	folk	dräkt
folketymologi	folk	etymologi
folkfest	folk	fest
folkgrupp	folk	grupp
folkhem	folk	hem
folkhemspolitiker	folkhem	s	politiker
folkhjälte	folk	hjälte
folkhälsa	folk	hälsa
folkhälsofara	folkhälsa	fara
folkhälsoinsats	folkhälsa	insats
folkhögskola	folk	högskola
folkhögskolekurs	folkhögskola	kurs
folkkyrka	folk	kyrka
folkledare	folk	ledare
folklig	folk	lig
folkliv	folk	liv
folklivsforskare	folkliv	s	forskare
folklivsforskning	folkliv	s	forskning
folklivsskildring	folkliv	s	skildring
folkmassa	folk	massa
folkminne	folk	minne
folkminnesarkiv	folkminne	s	arkiv
folkminnesforskning	folkminne	s	forskning
folkmord	folk	mord
folkmun	folk
folkmusik	folk	musik
folkmusikfestival	folkmusik	festival
folkmusikforskare	folkmusik	forskare
folkmusikgrupp	folkmusik	grupp
folkmängd	folk	mängd
folkmängdsökning	folkmängd	s	ökning
folkmål	folk	mål
folkmålsforskare	folkmål	s	forskare
folkomflyttning	folk	omflyttning
folkomröstning	folk	omröstning
folkpark	folk	park
folkparksscen	folkpark	s	scen
folkparksturné	folkpark	s	turné
folkpension	folk	pension
folkpensionsålder	folkpension	s	ålder
folkpensionär	folk	pensionär
folkrepresentation	folk	representation
folkrepublik	folk	republik
folkräkning	folk	räkning
folkrätt	folk	rätt
folkrättsbrott	folkrätt	s	brott
folkrättsexpert	folkrätt	s	expert
folkrättsjurist	folkrätt	s	jurist
folkrörelse	folk	rörelse
folksaga	folk	saga
folksamling	folk	samling
folksjukdom	folk	sjukdom
folkskola	folk	skola
folkskoleseminarium	folkskola	seminarium
folksport	folk	sport
folkstorm	folk	storm
folktradition	folk	tradition
folkvandring	folk	vandring
fondandel	fond	andel
fondbransch	fond	bransch
fordonsmekaniker	fordon	s	mekaniker
fordonsägare	fordon	s	ägare
fordring	fordra	ing
forensiskt	forensisk	t
formatera	format	era
formfranska	form	franska
formgivare	formgiva	are
formgivning	formgiva	ning
formmässig	form	mässig
formulering	formulera	ing
fornlämningsförklara	fornlämning
fornslavisk	forn	slavisk
forskare	forska	are
forskning	forska	ning
forskningsanknytning	forskning	s	anknytning
forskningsanläggning	forskning	s	anläggning
forskningsanslag	forskning	s	anslag
forskningsanstalt	forskning	s	anstalt
forskningsarbete	forskning	s	arbete
forskningsartikel	forskning	s	artikel
forskningsassistent	forskning	s	assistent
forskningsavdelning	forskning	s	avdelning
forskningsbidrag	forskning	s	bidrag
forskningschef	forskning	s	chef
forskningsenhet	forskning	s	enhet
forskningsexpedition	forskning	s	expedition
forskningsfartyg	forskning	s	fartyg
forskningsframgång	forskning	s	framgång
forskningsfråga	forskning	s	fråga
forskningsfält	forskning	s	fält
forskningsgenomgång	forskning	s	genomgång
forskningsgrupp	forskning
forskningsinsats	forskning	s	insats
forskningsinstitut	forskning	s	institut
forskningskompetens	forskning	s	kompetens
forskningsledare	forskning	s	ledare
forskningsmiljö	forskning	s	miljö
forskningsminister	forskning	s	minister
forskningsmässig	forskning	s	mässig
forskningsområde	forskning	s	område
forskningspark	forskning	s	park
forskningsprogram	forskning	s	program
forskningsprojekt	forskning	s	projekt
forskningsproposition	forskning	s	proposition
forskningsrapport	forskning	s	rapport
forskningsresa	forskning	s	resa
forskningsresultat	forskning	s	resultat
forskningsresurs	forskning	s	resurs
forskningsråd	forskning	s	råd
forskningssamarbete	forskning	s	samarbete
forskningssatsning	forskning	s	satsning
forskningsstation	forskning	s	station
forskningsstiftelse	forskning	s	stiftelse
forskningsstudie	forskning	s	studie
forskningsuppdrag	forskning	s	uppdrag
forskningsuppgift	forskning	s	uppgift
forskningsöversikt	forskning	s	översikt
fortifikationsförvaltning	fortifikation	s	förvaltning
fortplantningsorgan	fortplantning	s	organ
fortsättning	fortsätta	ning
fortsättningsvis	fortsättning	s	vis
fossilfri	fossil	fri
fossilgas	fossil	gas
fosterländskt	fosterländsk	t
fostervatten	foster	vatten
fotboll	fot	boll
fotbollsarena	fotboll	s	arena
fotbollsdomare	fotboll	s	domare
fotbollslandskamp	fotboll	landskamp
fotbollsliga	fotboll	s	liga
fotbollsmålvakt	fotboll	s	målvakt
fotbollsresa	fotboll	s	resa
fotbollsspelare	fotboll	s	spelare
fotbollsstjärna	fotboll	s	stjärna
fotografera	fotograf	era
fotografering	fotografera	ing
fotomodell	foto	modell
fragmentera	fragment	era
framkallning	framkalla	ning
framställning	framställa	ning
framtidsbild	framtid	s	bild
framtidsforskare	framtid	s	forskare
framtidsplan	framtid	plan
framöver	fram	över
franskspråkig	fransk	språkig
frasera	fras	era
frasering	frasera	ing
frasig	fras	ig
fredagsmys	fredag	s	mys
fredsinsats	fred	s	insats
fredsmöte	fred	s	möte
fredspipa	fred	pipa
fredssoldat	fred	s	soldat
fredsstyrka	fred	s	styrka
fredstid	fred	s	tid
frenetiskt	frenetisk	t
frestare	fresta	are
frigivning	frigiva	ning
frihamn	fri	hamn
frihet	fri	het
frihetsrörelse	frihet	s	rörelse
friidrottskommentator	friidrott	s	kommentator
frikyrklig	frikyrka	lig
frilansare	frilansa	are
friskförklara	frisk	förklara
friskförklaring	friskförklara	ing
friskhet	frisk	het
friskvårdsanläggning	friskvård	s	anläggning
frispråkig	fri	språkig
frisörskola	frisör	skola
fritering	fritera	ing
fritidsaktivitet	fritid	s	aktivitet
fritidshem	fritid	s	hem
fritidshus	fritid	s	hus
fritidsintresse	fritid	s	intresse
fritidspedagog	fritid	s	pedagog
fritidspolitiker	fritid	s	politiker
frukostbord	frukost	bord
frukostera	frukost	era
frukostkorv	frukost	korv
frukostmatsal	frukost	matsal
frukostrast	frukost	rast
frukostvärd	frukost	värd
fruktaffär	frukt	affär
fruktbar	frukta	bar
fruktig	frukt	ig
fruktkniv	frukt	kniv
fruktsam	frukt	sam
fruktsoppa	frukt	soppa
fruktträd	frukt	träd
frusenhet	frusen	het
fryspunkt	frys	punkt
fräckt	fräck	t
frälsning	frälsa	ning
främlingsfientlighet	främlingsfientlig	het
främlingsrädsla	främling	s	rädsla
frånskiljare	från	skilja
fuktighet	fuktig	het
fulimporterad	ful	importerad
fullmaktsformulär	fullmakt	s	formulär
fullmaktsgivare	fullmakt	s	givare
fullständigt	fullständig	t
fundamentalism	fundamental	ism
fundamentalist	fundamental	ist
fundering	fundera	ing
fundersam	fundera	sam
funktionellt	funktionell	t
funktionera	funktion	era
funktionsförmåga	funktion	s	förmåga
fusionera	fusion	era
fuskare	fuska	are
fyllighet	fyllig	het
fyllning	fylla	ning
fyraårig	fyra	årig
fysiologiskt	fysiologisk	t
fäktning	fäkta	ning
fällning	fälla	ning
fältarbetare	fält	arbetare
fältmässig	fält	mässig
fältväbel	fält	väbel
fängelsecell	fängelse	cell
färdbevis	färd	bevis
färdig	färd	ig
färdighet	färdig	het
färdmedel	färd	medel
färdtjänstförare	färdtjänst	förare
färgsättning	färgsätta	ning
fästning	fästa	ning
fågelbajs	fågel	bajs
fågelbord	fågel	bord
fågelhund	fågel	hund
fågelkött	fågel	kött
fågelparasit	fågel	parasit
fågelskådare	fågelskåda	are
fågelskådning	fågelskåda	ning
fågelägg	fågel	ägg
fånig	fån	ig
fånigt	fånig	t
fårkött	får	kött
födelsebevis	födelse	bevis
födelsedag	födelse	dag
födelsedagsgåva	födelsedag	s	gåva
födelsedagskort	födelsedag	s	kort
födelseår	födelse	år
födokälla	föda	o	källa
följare	följa	are
följdsjukdom	följd	sjukdom
fönsterbord	fönster	bord
förakta	för	akta
förankra	för	ankra
förankring	förankra	ing
föranmäla	för	anmäla
förare	föra	are
förbanna	för	banna
förbehandling	för	behandling
förbehålla	för	behålla
förbereda	för	bereda
förbeställa	för	beställa
förbeställning	förbeställa	ning
förbinda	för	binda
förbjuda	för	bjuda
förbli	för	bli
förblöda	för	blöda
förboka	för	boka
förborga	för	borga
förbruka	för	bruka
förbrukning	förbruka	ning
förbränna	för	bränna
förbudsskylt	förbud	skylt
förbundskapten	förbund	s	kapten
förbundsväg	förbund	s	väg
förbygga	för	bygga
förbyta	för	byta
förbättra	för	bättra
förbättring	förbättra	ing
fördela	för	dela
fördelaktigt	fördelaktig	t
fördelare	fördela	are
fördelning	fördela	ning
fördjupning	fördjupa	ning
fördriva	för	driva
fördröja	för	dröja
fördröjning	fördröja	ning
fördubbla	för	dubbla
fördubbling	fördubbla	ing
fördöma	för	döma
förebygga	före	bygga
föredra	före	dra
förefalla	före	falla
föregiva	före	giva
föregripa	före	gripa
föregå	före	gå
förekomma	före	komma
föreligga	före	ligga
föreläsa	före	läsa
föreläsare	föreläsa	are
föreläsning	föreläsa	ning
föremål	före	mål
förena	för	ena
föreningsaktivitet	förening	s	aktivitet
föreningsbidrag	förening	s	bidrag
föreningshus	förening	s	hus
föreningsliv	förening	s	liv
förenkling	förenkla	ing
förenlighet	förenlig	het
föreskriva	före	skriva
föreslå	före	slå
förespegla	före	spegla
förespråkare	förespråka	are
föreställa	före	ställa
föreställning	föreställa	ning
föreställningsvärld	föreställning	s	värld
förestå	före	stå
företa	före	ta
företagare	företag	are
företagsam	företag	sam
företagsamhet	företagsam	het
företagsekonom	företag	s	ekonom
företagsgrupp	företag	s	grupp
företagshemlighet	företag	s	hemlighet
företagsjurist	företag	s	jurist
företagskonsult	företag	s	konsult
företagsläkare	företag	s	läkare
företagsnamn	företag	s	namn
företagsprenumeration	företag	s	prenumeration
företagsutbildning	företag	s	utbildning
företräda	före	träda
företrädare	företräda	are
företrädesvis	företräde	s	vis
förfalla	för	falla
förfalskning	förfalska	ning
författa	för	fatta
författare	författa	are
författarskap	författare
författning	författa	ning
författningssamling	författning	s	samling
förfinskning	förfinska	ning
förflytta	för	flytta
förflyttning	förflytta	ning
förfoga	för
förfrysa	för	frysa
förfäkta	för	fäkta
förfölja	för	följa
förföljare	förfölja	are
förföra	för	föra
förfördela	för	fördela
förgasa	för	gasa
förgasare	förgasa	are
förgifta	för	gifta
förgiftning	förgifta	ning
förgiftningssymtom	förgiftning	s	symtom
förgrädda	för	grädda
förgyllare	förgylla	are
förgå	för	gå
förgöra	för	göra
förhala	för	hala
förhandla	för	handla
förhandlare	förhandla	are
förhandling	förhandla	ing
förhandlingsbord	förhandling	s	bord
förhandsröstning	förhandsrösta	ning
förhasta	för	hasta
förhindra	för	hindra
förhoppningsvis	förhoppning	s	vis
förhärska	för	härska
förhålla	för	hålla
förhållandevis	förhållande	vis
förhöja	för	höja
förhöjning	förhöja	ning
förhöra	för	höra
förinställa	för	inställa
förinta	för	inta
förkasta	för	kasta
förkastning	förkasta	ning
förklara	för	klara
förklaring	förklara	ing
förklistra	för	klistra
förklä	för	klä
förknippning	förknippa	ning
förkoka	för	koka
förkomma	för	komma
förkortning	förkorta	ning
förkrossa	för	krossa
förkunna	för	kunna
förkunnare	förkunna	are
förleda	för	leda
förlikning	förlika	ning
förlisning	förlisa	ning
förlossa	för	lossa
förlossning	förlossa	ning
förlossningsanstalt	förlossning	s	anstalt
förlossningsavdelning	förlossning	s	avdelning
förlossningsklinik	förlossning	s	klinik
förlossningsläkare	förlossning	s	läkare
förlossningsmottagning	förlossning	s	mottagning
förlossningspedagog	förlossning	s	pedagog
förlossningsskada	förlossning	s	skada
förlossningssmärta	förlossning	s	smärta
förlossningsvärk	förlossning	s	värk
förlusta	för	lusta
förlägga	för	lägga
förläggare	förlägga	are
förläggning	förlägga	ning
förlängare	förlänga	are
förlängning	förlänga	ning
förlåta	för	låta
förmana	för	mana
förmedla	för	medla
förmedlare	förmedla	are
förmedling	förmedla	ing
förmedlingsuppdrag	förmedling	s	uppdrag
förminska	för	minska
förminskning	förminska	ning
förmultna	för	multna
förmå	för	må
förmånlig	förmån	lig
förmögenhet	förmögen	het
förnedring	förnedra	ing
förnedringsrån	förnedring	rån
förneka	för	neka
förnekare	förneka	are
förning	föra	ning
förnuftigt	förnuftig	t
förnyare	förnya	are
förnybar	förnya	bar
förnärma	för	närma
förordna	för	ordna
förordning	förorda	ning
förorena	för	orena
förorsaka	för	orsaka
förortsbo	förort	s	bo
förortslägenhet	förort	s	lägenhet
förpacka	för	packa
förpackare	förpacka	are
förpackning	förpacka	ning
förpassa	för	passa
förpricka	för	pricka
förringa	för	ringa
församla	för	samla
församling	församla	ing
församlingsassistent	församling	s	assistent
församlingshem	församling	s	hem
församlingshus	församling	s	hus
församlingskyrka	församling	s	kyrka
församlingsmedlem	församling	s	medlem
församlingspräst	församling	s	präst
förse	för	se
försegla	för	segla
försenare	försena	are
försiktighet	försiktig	het
försiktigt	försiktig	t
försinka	för	sinka
försjunka	för	sjunka
förskansning	förskansa	ning
förskingra	för	skingra
förskingrare	förskingra	are
förskingring	förskingra	ing
förskjuta	för	skjuta
förskjutning	förskjuta	ning
förskona	för	skona
förskriva	för	skriva
förskrivning	förskriva	ning
förslagsvis	förslag	s	vis
förslappa	för	slappa
förslappning	förslappa	ning
förslava	för	slava
förslita	för	slita
förslitning	förslita	ning
försluta	för	sluta
förslutning	försluta	ning
förslösa	för	slösa
försmäkta	för	smäkta
förspel	för	spel
förspilla	för	spilla
förstelna	för	stelna
förstena	för	stena
förstoring	förstora	ing
förströ	för	strö
förställa	för	ställa
förstärka	för	stärka
förstärkning	förstärka	ning
förstå	för	stå
förståndig	förstånd	ig
förstöra	för	störa
försumbart	försumbar	t
försura	för	sura
försvara	för	svara
försvarare	försvara	are
försvarlig	försvar	lig
försvarsbeslut	försvar	s	beslut
försvarsbudget	försvar	s	budget
försvarskyrka	försvar	s	kyrka
försvarssystem	försvar	s	system
försvenskning	försvenska	ning
försvinna	för	svinna
försäkra	för	säkra
försäkring	försäkra	ing
försäkringsbolag	försäkring	s	bolag
försäkringsersättning	försäkring	s	ersättning
försäkringsförmedlare	försäkring	s	förmedlare
försäkringshandläggare	försäkring	s	handläggare
försäkringskonsulent	försäkring	s	konsulent
försäkringsläkare	försäkring	s	läkare
försäkringsrådgivare	försäkring	s	rådgivare
försälja	för	sälja
försäljare	försälja	are
försäljning	försälja	ning
försämring	försämra	ing
försätta	för	sätta
försöka	för	söka
försöksperiod	försök	s	period
försörja	för	sörja
försörjning	försörja	ning
försörjningsstöd	försörjning	s	stöd
förtala	för	tala
förteckna	för	teckna
förtidsröstning	förtidsrösta	ning
förtiga	för	tiga
förtjusa	för	tjusa
förtjusning	förtjusa	ning
förtjäna	för	tjäna
förtro	för	tro
förtrolla	för	trolla
förtrycka	för	trycka
förtryckare	förtrycka	are
förtränga	för	tränga
förträngning	förtränga	ning
förtrösta	för	trösta
förtulla	för	tulla
förtullning	förtulla	ning
förtvivla	för	tvivla
förtycka	för	tycka
förtyskning	förtyska	ning
förtälja	för	tälja
förtära	för	tära
förtäta	för	täta
förtöja	för	töja
förundra	för	undra
förunna	för	unna
förutse	för	utse
förutsätta	för	utsätta
förutsättning	förutsätta	ning
förvaltare	förvalta	are
förvaltning	förvalta	ning
förvaltningsavgift	förvaltning	s	avgift
förvaltningsorganisation	förvaltning	s	organisation
förvandling	förvandla	ing
förvanskning	förvanska	ning
förvaring	förvara	ing
förvaringsskåp	förvaring	s	skåp
förvarna	för	varna
förvarning	för	varning
förverka	för	verka
förvirra	för	virra
förvirring	förvirra	ing
förvisa	för	visa
förvisning	förvisa	ning
förvissna	för	vissna
förvittra	för	vittra
förvrida	för	vrida
förvränga	för	vränga
förvrängning	förvränga	ning
förvägra	för	vägra
förvällning	förvälla	ning
förvänta	för	vänta
förväntning	förvänta	ning
förvärva	för	värva
förväxla	för	växla
förväxling	förväxla	ing
förädling	förädla	ing
föräldraledighet	föräldraledig	het
förändra	för	ändra
förändring	förändra	ing
förändringsprocess	förändring	s	process
förära	för	ära
förånga	för	ånga
föröda	för	öda
föröka	för	öka
föröva	för	öva
förövare	föröva	are
gallerist	galler	ist
gallring	gallra	ing
galning	galen	ning
gammaldags	gammal	dags
garantinivå	garanti	nivå
garantipension	garanti	pension
gardinklämma	gardin	klämma
garnera	garn	era
garnering	garnera	ing
garvare	garva	are
garvning	garva	ning
gasfackla	gas	fackla
gasflak	gas	flak
gasfyndighet	gas	fyndighet
gasförbehandling	gas	förbehandling
gaslager	gas	lager
gasledning	gas	ledning
gasmask	gas	mask
gastera	gast	era
gatuköksbiträde	gatukök	s	biträde
gatuloppis	gata	u	loppis
gemensamt	gemensam	t
genera	gen	era
generalisera	general	isera
generaliserbar	generalisera	bar
generalist	general	ist
generellt	generell	t
genitivform	genitiv	form
genombrottsinfektion	genombrott	infektion
genombryta	genom	bryta
genomlysning	genomlysa	ning
genomläsning	genomläsa	ning
genomsippra	genom
genomsnittlig	genomsnitt	lig
genomtänkt	genom	tänkt
genredigering	genredigera	ing
genremässig	genre	mässig
gensax	gen	sax
gensekvensera	gensekvens	era
genusforskare	genus	forskare
genusforskning	genus	forskning
genusmedvetenhet	genus	medvetenhet
genuspedagogik	genus	pedagogik
genusvetenskap	genus	vetenskap
geografiskt	geografisk	t
geopolitiskt	geopolitisk	t
germanisera	german	isera
germanism	german	ism
gestaltning	gestalta	ning
giftig	gift	ig
giftighet	giftig	het
giggare	gigga	are
giltighet	giltig	het
girigbuk	girig	buk
girighet	girig	het
gissning	gissa	ning
gissningsvis	gissning	s	vis
gitarrist	gitarr	ist
gitarrlärare	gitarr	lärare
givare	giva	are
gjutare	gjuta	are
glansig	glans	ig
glasarbetare	glas	arbetare
glasbruk	glas	bruk
glasera	glas	era
glaskonstnär	glas	konstnär
glasmästare	glas	mästare
glassbil	glass	bil
glassbilsförare	glassbil	s	förare
glassbåt	glass	båt
glastak	glas	tak
glasäpple	glas	äpple
glesbygdsskola	glesbygd	s	skola
globalt	global	t
glutenfri	gluten	fri
glödlampa	glöd	lampa
glödning	glöda	ning
gnagare	gnaga	are
gnetig	gnet	ig
godisbutik	godis	butik
godtyckligt	godtycklig	t
golare	gola	are
golfare	golfa	are
golfbil	golf	bil
gossebarn	gosse	barn
gradera	grad	era
gradvis	grad	vis
grammatikregel	grammatik	regel
granskare	granska	are
granskning	granska	ning
granskningsinsats	granskning	insats
gratinering	gratinera	ing
gravera	grav	era
gravläggningsgudstjänst	grav	läggning	s	gudstjänst
gravsättning	grav	sättning
grillplats	grill	plats
grimasera	grimas	era
griskulting	gris	kulting
griskött	gris	kött
grumling	grumla	ing
grundare	grunda	are
grundligt	grundlig	t
grundlös	grund	lös
grundstötning	grundstöta	ning
grundvatten	grund	vatten
grupparbeta	grupp	arbeta
gruppbostad	grupp	bostad
gruppera	grupp	era
gruppering	gruppera	ing
gruppfinal	grupp	final
gruppförsäkring	grupp	försäkring
gruppledare	grupp	ledare
gruppmedlem	grupp	medlem
gruppresa	grupp	resa
gruppsamtal	grupp	samtal
gruppträning	grupp	träning
gruppträningsinstruktör	gruppträning	s	instruktör
gruppuppgift	grupp	uppgift
grymhet	grym	het
grymt	grym	t
grynig	gryn	ig
grynkorv	gryn	korv
gräddning	grädda	ning
gränslös	gräns	lös
gränspendlare	gräns	pendlare
grävmaskinist	grävmaskin	ist
grävning	gräva	ning
grönkålssoppa	grönkål	s	soppa
grönsaksbuljong	grönsak	s	buljong
grönsaksjuice	juice	jos	grönsak
gubbslem	gubbe	slem
gudomligt	gudomlig	t
guldsked	guld	sked
gullig	gula	lig
gycklare	gyckla	are
gymnasieutbildning	gymnasium	utbildning
gynekologiskt	gynekologisk	t
gynnare	gynna	are
gängkonflikt	gäng	konflikt
gängskjutning	gäng	skjutning
gänguppgörelse	gäng	uppgörelse
gäspning	gäspa	ning
gästarbetare	gäst	arbetare
gästforskare	gäst	forskare
gäststudent	gäst	student
gårdshus	gård	s	hus
gårdsmästare	gård	s	mästare
gårdvar	gård	var
gåsfjäder	gås	fjäder
gödselbrunn	gödsel	brunn
göteborgare	Göteborg	are
habilitering	habilitera	ing
hackare	hacka	are
hallonbåt	hallon	båt
hallonpaj	hallon	paj
halsband	hals	band
halsduk	hals	duk
halsgrop	hals	grop
halvalgerisk	halv	algerisk
halvamerikansk	halv	amerikansk
halvdansk	halv	dansk
halvtuggad	halv
hamnarbetare	hamn	arbetare
hamnbassäng	hamn	bassäng
hamninlopp	hamn	inlopp
hamnstyrelse	hamn	styrelse
handbok	hand	bok
handbollsklubb	handboll	s	klubb
handduk	hand	duk
handelsförbud	handel	s	förbud
handelspolitik	handel	politik
handelsresa	handel	s	resa
handgranat	hand	granat
handlare	handla	are
handledare	handleda
handledning	handleda	ning
handling	handla	ing
handläggare	handlägga	are
handläggning	handlägga	ning
hanterbar	hantera	bar
hantering	hantera	ing
hantverkare	hantverk	are
harmoniera	harmoni	era
harpunerare	harpunera	are
hashpussel	hash	pussel
hastig	hast	ig
hastighet	hastig	het
hastigt	hastig	t
havsdjur	hav	s	djur
havsnivå	hav	nivå
havsyta	hav	yta
hederlig	heder	lig
hedersdoktor	heder	s	doktor
hedersförtryck	heder	s	förtryck
hederskultur	heder	s	kultur
hedersmotiv	heder	s	motiv
hedersnorm	heder	s	norm
hedersrelaterad	heder	s	relaterad
helgdag	helg	dag
helhet	hel	het
helhetsgrepp	helhet	s	grepp
helnykterist	helnykter	ist
helt	hel	t
helår	hel	år
hemadress	hem	adress
hemarbete	hem	arbete
hembesök	hem	besök
hembiträde	hem	biträde
hembygd	hem	bygd
hembygdsforskare	hembygd	s	forskare
hemförsäkring	hem	försäkring
heminredning	hem	inredning
hemisfär	sfär
hemkommun	hem	kommun
hemleverans	hem	leverans
hemlig	hem	lig
hemlighet	hemlig	het
hemläxa	hem	läxa
hemlös	hem	lös
hemlöshet	hemlös	het
hemort	hem	ort
hemspråk	hem	språk
hemspråksundervisning	hemspråk	s	undervisning
hemstad	hem	stad
herrelös	herre	lös
herrgårdsbyggnad	herrgård	s	byggnad
hinkvis	hink	vis
hisstekniker	hiss	tekniker
hjälmprydnad	hjälm	prydnad
hjälpinsats	hjälp	insats
hjälpkommitté	hjälp	kommitté
hjälplös	hjälp	lös
hjälplöshet	hjälplös	het
hjälporganisation	hjälp	organisation
hjälpsam	hjälp	sam
hjärnskakning	hjärna	skakning
hobbyepidemiolog	hobby	epidemiolog
hobbyverksamhet	hobby	verksamhet
holistiskt	holistisk	t
homogenisera	homogen	isera
homoseksualitet	homo-	sexualitet
homosexualitet	homo	sexualitet
hoppare	hoppa	are
hopplös	hopp	lös
hopplöst	hopplös	t
hostning	hosta	ning
hotellbransch	hotell	bransch
hotellfrukost	hotell	frukost
hotellgäst	hotell	gäst
hotellnatt	hotell	natt
hotellsäng	hotell	säng
hovdam	hov	dam
hovreporter	hov	reporter
hovrättsprövning	hovrätt	s	prövning
hudsjukdom	hud	sjukdom
huggare	hugga	are
humanisera	human	isera
humanism	human	ism
humanist	human	ist
humanitärt	humanitär	t
humorist	humor	ist
humorlös	humor	lös
hunddagis	hund	dagis
hundgård	hund	gård
hundhalsband	hund	halsband
hundkurs	hund	kurs
hundraårig	hundra	årig
hundägare	hund	ägare
hungerpandemi	hunger	pandemi
husbil	hus	bil
husbilssemester	husbil	s	semester
husbonde	hus	bonde
husbyggnad	hus
husera	hus	era
husförhör	hus	förhör
hushållning	hushålla	ning
hushållsrulle	hushåll	s	rulle
huskropp	hus	kropp
huslig	hus	lig
husvägg	hus	vägg
huvudbonad	huvud	bonad
huvuddel	huvud	del
huvudförhandling	huvud	förhandling
huvudgata	huvud	gata
huvudgärd	huvud	gärde
huvudinnehåll	huvud
huvudord	huvud	ord
huvudperson	huvud	person
huvudsaklig	huvudsak	lig
huvudsekreterare	huvud	sekreterare
huvudskyddsombud	huvud	skyddsombud
hycklare	hyckla	are
hydrologiskt	hydrologisk	t
hyllning	hylla	ning
hymenoplastikkirurgi	hymenoplastik	kirurg
hyvling	hyvla	ing
häckling	häckla	ing
häktning	häkta	ning
hälsing	hälsa	ing
hälsning	hälsa	ning
hälsolitteracitet	hälsa	litteracitet
hämtning	hämta	ning
händelsevis	händelse	vis
hängare	hänga	are
hänsynslöst	hänsynslös	t
hänvisning	hänvisa	ning
häradshövding	härad	s	hövding
häradsrätt	härad	rätt
härjning	härja	ning
härlig	här	lig
härlighet	härlig	het
härligt	härlig	t
härskare	härska	are
hästflicka	häst	flicka
hästlös	häst	lös
hästtjej	häst	tjej
hållare	hålla	are
hållbar	hålla	bar
hållbarhet	hållbar	het
hållbarhetsmärkning	hållbarhet	s	märkning
hållbart	hållbar	t
hållning	hålla	ning
hållpunkt	håll	punkt
hårborste	hår	borste
hårdhet	hård	het
hårdvara	hård	vara
hårig	hår	ig
hårnål	hår	nål
hårsalong	hår	salong
högerparti	höger	parti
högfjäll	hög	fjäll
högfärdigt	högfärdig	t
högkyrklighet	högkyrklig	het
högskola	hög	skola
högskoleutbildning	högskola	utbildning
högspänning	hög	spänning
högspänningskabel	högspänning	s	kabel
högspänningsledning	högspänning	s	ledning
höjning	höja	ning
hörbar	höra	bar
hörbarhet	hörbar	het
hörntand	hörn	tand
höstdag	höst	dag
höstkantarell	höst	kantarell
höstkrokus	höst
höstsäsong	höst	säsong
hösttermin	höst	termin
hövligt	hövlig	t
iakttagare	iakttaga	are
idealisera	ideal	isera
idealist	ideal	ist
idealvärld	ideal	värld
identifiering	identifiera	ing
ideologiskt	ideologisk	t
idiotförklara	idiot	förklara
idkare	idka	are
idrottare	idrotta	are
idrottsfolkhögskola	idrott	s	folkhögskola
idrottsförbund	idrott	s	förbund
idrottsförening	idrott	s	förening
idrottshall	idrott	s	hall
idrottshögskola	idrott	s	högskola
idrottsklubb	idrott	s	klubb
idrottskvinna	idrott	s	kvinna
idrottsläkare	idrott	s	läkare
idrottslärare	idrott	s	lärare
idrottsminister	idrott	s	minister
idrottspsykolog	idrott	s	psykolog
idrottstränare	idrott	s	tränare
idélös	idé	lös
idémässig	idé	mässig
igenkännbar	igenkänna	bar
igenkännbarhet	igenkänna	barhet
igång	i	gång
ihålighet	ihålig	het
ilning	ila	ning
imamutbildning	imam	utbildning
immunitetspass	immunitet	pass
immunologiskt	immunologisk	t
implementering	implementera	ing
importera	import	era
inbesparing	inbespara	ing
inbetalning	inbetala	ning
inbillning	inbilla	ning
inbjudning	inbjuda	ning
inblandning	inblanda	ning
inbyggare	inbygga	are
indelning	indela	ning
indexera	index	era
indexering	indexera	ing
individualistiskt	individualistisk	t
indragning	indraga	ning
industribyggnad	industri	byggnad
industriföretag	industri	företag
industriinriktning	industri	inriktning
industrimuseum	industri	museum
industrisömmerska	industri	sömmerska
industriutställning	industri	utställning
influerare	influera	are
inflyttning	inflytta	ning
infodemi	epidemi	information
informationsarkitekt	information	s	arkitekt
informationsbehandling	information	s	behandling
informationsklassning	informationsklassa	ning
informationsläcka	information	s	läcka
informationsmaterial	information	s	material
informationsskylt	information	s	skylt
informationssystem	information	system
informationssäkerhet	information	s	säkerhet
informationssäkerhetsexpert	informationssäkerhet	s	expert
informationstext	information
informellt	informell	t
infrastrukturinvestering	infrastruktur	investering
infrastrukturprojekt	infrastruktur	projekt
ingenjörsutbildning	ingenjör	s	utbildning
inhämta	in	hämta
initiativlös	initiativ	lös
injektionsbehandling	injektion	s	behandling
inkludering	inkludera	ing
inkomstmässig	inkomst	mässig
inkomstpension	inkomst	pension
inkorporering	inkorporera	ing
inköpare	inköpa	are
inledare	inleda	are
inledning	inleda	ning
inledningsvis	inledning	s	vis
inläggning	inlägga	ning
inlämna	in	lämna
inlämning	inlämna	ning
inlåna	in	låna
innovationscheck	innovation
innovationssystem	innovation
inofficiell	in
inredning	inreda	ning
inriktad	in	riktad
inriktning	inrikta	ning
inriktningsbeslut	inriktning	s	beslut
inropare	inropa	are
inrymma	in	rymma
inrättning	inrätta	ning
insatsgrupp	insats	grupp
insiderbrott	insider
inskränkning	inskränka	ning
inspelningsplats	inspelning	s	plats
instagrammare	instagramma	are
instrumentmakare	instrument	makare
inställning	inställa	ning
insyn	in	syn
insändare	insända	are
insättning	insätta	ning
intensivt	intensiv	t
intermediärvård	intermediär	vård
intermediärvårdsavdelning	intermediärvård	s	avdelning
internatelev	internat	elev
internationellt	internationell	t
internatskola	internat	skola
interpellationssvar	interpellation	s	svar
intervjuare	intervjua	are
intimitetskoordinator	intimitet	koordinator
intimkirurgi	intim	kirurg
intimt	intim	t
intresseförening	intresse	förening
intresseområde	intresse	område
invandrare	invandra	are
invandring	invandra	ing
invasionsstyrka	invasion	s	styrka
investerare	investera	are
investering	investera	ing
investeringsfond	investering	s	fond
investeringsobjekt	investering	s	objekt
invigning	inviga	ning
involvering	involvera	ing
invändning	invända	ning
iscensätta	i	scen	sätta
iscensättning	iscensätta	ning
isflak	is	flak
ishockey	is	hockey
islamisera	islam	isera
islamist	islam	ist
ismassa	is	massa
isolering	isolera	ing
italienskspråkig	italiensk	språkig
jagare	jaga	are
jaktbrott	jakt	brott
jaktgevär	jakt	gevär
jobbcoach	jobb	coach
jobbig	jobb	ig
jobbigt	jobbig	t
jobbresa	jobb	resa
jobbsamtal	jobb	samtal
joggare	jogga	are
jonisera	jon	isera
jordatmosfär	atmosfär
jordbruksanläggning	jordbruk	s	anläggning
jordbruksmaskin	jordbruk	s	maskin
jordbruksminister	jordbruk	s	minister
jordbrukspolitiskt	jordbrukspolitisk	t
jordfel	jord	fel
jordfelsbrytare	jordfel	brytare
jordlös	jord	lös
journalhandling	journal	handling
journalist	journal	ist
journalisthögskola	journalist	högskola
journaliststudent	journalist	student
jourpass	jour	pass
jubileumsutgåva	jubileum	s	utgåva
julbord	jul	bord
julgädda	jul	gädda
julkorv	jul	korv
juridiskt	juridisk	t
juristbyrå	jurist	byrå
juristexamen	jurist	examen
juristkonsult	jurist	konsult
juriststudent	jurist	student
juristutbildning	jurist	utbildning
jurygrupp	jury
jurymöte	jury
justerare	justera	are
justering	justera	ing
jämförbar	jämföra	bar
jämförelsevis	jämförelse	vis
jämkning	jämka	ning
jämlikhet	jämlik	het
jämnt	jämn	t
jämställdhet	jämställd	het
jämställdhetsfråga	jämställdhet	s	fråga
järnbruk	järn	bruk
järngrind	järn	grind
järnmalm	järn	malm
järnmalmsgruva	järnmalm	s	gruva
järnproduktion	järn	produktion
järnvägsarkitekt	järnväg	s	arkitekt
järnvägsbolag	järnväg	s	bolag
järnvägsområde	järnväg	s	område
järnvägssystem	järnväg	s	system
järnvägstrafik	järnväg	s	trafik
järnvägsunderhåll	järnväg	s	underhåll
järnvägsvagn	järnväg	s	vagn
järnvägsövergång	järnväg	s	övergång
jäsning	jäsa	ning
jättelik	jätte	lik
jättelång	jätte	lång
kabelbana	kabel	bana
kabelbro	kabel	bro
kabelbrott	kabel	brott
kabelbrunn	kabel	brunn
kabelfel	kabel	fel
kabelskåp	kabel	skåp
kaffeflicka	kaffe	flicka
kaffegrädde	kaffe	grädde
kaffetår	kaffe	tår
kalkylera	kalkyl	era
kallelsetid	kallelse	tid
kalligrafera	kalligraf	era
kalvkotlett	kalv	kotlett
kalvkött	kalv	kött
kammare	kamma	are
kammarrättspresident	kammarrätt	s	president
kampanjfilm	kampanj	film
kampanjmöte	kampanj	möte
kampanjorganisation	kampanj	organisation
kamratlig	kamrat	lig
kanalbank	kanal	bank
kanalisera	kanal	isera
kandidatprogram	kandidat	program
kanelbulle	kanel	bulle
kanelkrans	kanel	krans
kanelsnurra	kanel	snurra
kanelstång	kanel
kanonisera	kanon	isera
kanonport	kanon	port
kanskeman	kanske	man
kantorsexamen	kantor	s	examen
kantorsutbildning	kantor	s	utbildning
kapitalism	kapital	ism
kapitalist	kapital	ist
kapitalmässig	kapital	mässig
kapplopp	kapp
karaktärsroll	karaktär	s	roll
karamellisera	karamell	isera
karikatyrtecknare	karikatyr	tecknare
karriärcoach	karriär	coach
karriärmässig	karriär	mässig
kartläggning	kartlägga	ning
kassakista	kassa	kista
kassareserv	kassa	reserv
kassaskåp	kassa	skåp
kassör	kassa	ör
katalanskspråkig	katalansk	språkig
katalogisera	katalog	isera
katalogisering	katalogisera	ing
katedralkyrka	katedral	kyrka
kategorisering	kategorisera	ing
kategoriträd	kategori	träd
kattförsäkring	katt	försäkring
kattlucka	katt	lucka
kattpensionat	katt	pensionat
kedjerökare	kedjeröka	are
kemilärare	kemi	lärare
kemistudent	kemi	student
kidnappare	kidnappa	are
kidnappning	kidnappa	ning
kikare	kika	are
kirurgmottagning	kirurg	mottagning
kittlare	kittla	are
kladdig	kladd	ig
klangmässig	klang	mässig
klantig	klant	ig
klarhet	klar	het
klarinettist	klarinett	ist
klarspråkig	klar	språkig
klassificering	klassificera	ing
klasskamrat	klass	kamrat
klassmässig	klass	mässig
klassrumsdörr	klassrum	s	dörr
klensmedja	klen	smedja
klick-ljud	klick	ljud
klimataktivist	klimat	aktivist
klimatanläggning	klimat	anläggning
klimatanpassa	klimat	anpassa
klimatanpassning	klimat	anpassning
klimatavtryck	klimat	avtryck
klimatbiljett	klimat	biljett
klimatbistånd	klimat	bistånd
klimatbonus	klimat	bonus
klimatbonusbil	klimatbonus	bil
klimatdeklaration	klimat	deklaration
klimatdiktatur	klimat	diktatur
klimatetik	klimat	etik
klimatflykting	klimat	flykting
klimatforskare	klimat	forskare
klimatforskning	klimat	forskning
klimatfrämjande	klimat	främjande
klimatfråga	klimat	fråga
klimatförnekare	klimat	förnekare
klimatförsenare	klimat	försenare
klimatförändring	klimat	förändring
klimatförändringskommunikation	klimatförändring	s	kommunikation
klimatförändringsutbildning	klimatförändring	s	utbildning
klimatinsats	klimat	insats
klimatkompensation	klimat	kompensation
klimatkompensera	klimat	kompensera
klimatkorrespondent	klimat	korrespondent
klimatkänslighet	klimat	känslighet
klimatlag	klimat	lag
klimatminister	klimat	minister
klimatmodell	klimat	modell
klimatmål	klimat	mål
klimatnytta	klimat	nytta
klimatnödläge	klimat	nödläge
klimatomställning	klimat	omställning
klimatpolitik	klimat	politik
klimatresiliens	klimat	resiliens
klimatrisk	klimat	risk
klimatriskförsäkring	klimatrisk	försäkring	-s-
klimaträttvisa	klimat	rättvisa
klimatrörelse	klimat	rörelse
klimatskadestånd	klimat	skadestånd
klimatskeptiker	klimat	skeptiker
klimatskuld	klimat	skuld
klimatstrejk	klimat	strejk
klimatstrejka	klimat	strejka
klimatsystem	klimat	system
klimatsårbarhet	klimat	sårbarhet
klimatutmaning	klimat	utmaning
klimatväxling	klimat	växling
klimatzon	klimat	zon
klimatåtagande	klimat	åtagande
klimpfri	klimp	fri
kliniskt	klinisk	t
klippare	klippa	are
klippning	klippa	ning
klittstånd	klitt	stånd
klorera	klor	era
klosterskola	kloster	skola
klubbhus	klubb	hus
klubbmedlem	klubb	medlem
klumpfri	klump	fri
klumpig	klump	ig
klumpigt	klumpig	t
klumpsumma	klump	summa
kluvenhet	kluven	het
klyvare	klyva	are
klättrare	klättra	are
klättring	klättra	ing
klåpare	klåpa	are
knackning	knacka	ning
knarkare	knarka	are
knasboll	knasig	boll
knegare	knega	are
knivhota	kniv	hota
knivhugga	kniv	hugga
knivmord	kniv	mord
knivmördare	knivmörda	are
knulldocka	knull	docka
knullskrubb	knull	skrubb
knäppning	knäppa	ning
kodlinje	kod	linje
kokainist	kokain	ist
kokare	koka	are
kokbar	koka	bar
kokboksförfattare	kokbok	s	författare
kokettera	kokett	era
kokning	koka	ning
kolare	kola	are
koldioxidekvivalent	koldioxid	ekvivalent
koldioxidskatt	koldioxid	skatt
koldioxidsänka	koldioxid	sänka
kolhydratfri	kolhydrat	fri
kollektivt	kollektiv	t
kollektivtrafiksatsning	kollektivtrafik	satsning
kolsänka	kol	sänka
koltrast	kol	trast
kolumnist	kolumn	ist
komfortzon	komfort	zon
kommersiellt	kommersiell	t
kommunalförordning	förordning
kommunchef	kommun	chef
kommundirektör	kommun	direktör
kommunförbund	kommun	förbund
kommungräns	kommun	gräns
kommunhuvudort	kommun	huvudort
kommunikationsförmåga	kommunikation	s	förmåga
kommunikationskampanj	kommunikation	s	kampanj
kommunikationssvårighet	kommunikation	s	svårighet
kommunism	kommun	ism
kommunist	kommun	ist
kommunjurist	kommun	jurist
kommunminister	kommun	minister
kommunpolitiker	kommun	politiker
kommunsammanslagning	kommun	sammanslagning
kommunstyrelse	kommun	styrelse
kompensationsåtgärd	kompensation	s	åtgärd
kompetenscentrum	kompetens	centrum
kompetensstöd	kompetens
kompisgäng	kompis	gäng
komplettering	komplettera	ing
kompressorstation	kompressor	station
komprimering	komprimera	ing
kompromissförslag	kompromiss	förslag
kondensationspunkt	kondensation	s	punkt
konferensbidrag	konferens	bidrag
konferensvärd	konferens	värd
konferensvärdinna	konferens	värdinna
konfessionslöshet	konfessionslös	het
konfirmationsklänning	konfirmation	s	klänning
konfirmationspresent	konfirmation	s	present
konfirmationspräst	konfirmation	s	präst
konfiskering	konfiskera	ing
konfliktområde	konflikt	område
konfliktorsak	konflikt	orsak
konjunkturmässig	konjunktur	mässig
konkretisera	konkret	isera
konkurrensfördel	konkurrens	fördel
konkurrenskraftig	konkurrenskraft	ig
konkurrensmässig	konkurrens	mässig
konkurrensmässigt	konkurrensmässig	t
konkursmässig	konkurs	mässig
konsertbiljett	konsert	biljett
konservera	konserv	era
konstakademi	konst	akademi
konstföremål	konst	föremål
konstförening	konst	förening
konstig	konst	ig
konstigt	konstig	t
konstkritiker	konst	kritiker
konstmuseum	konst	museum
konstnärlig	konstnär	lig
konstnärligt	konstnärlig	t
konstruktionsmaterial	konstruktion	s	material
konstsamling	konst	samling
konstskola	konst	skola
konstverk	konst	verk
konstvetenskap	konst	vetenskap
konståkning	konst
konsultbolag	konsult	bolag
konsultbyrå	konsult	byrå
konsultera	konsult	era
konsultföretag	konsult	företag
konsultuppdrag	konsult	uppdrag
konsultutlåtande	konsult	utlåtande
kontaktperson	kontakt	person
kontaktuppgift	kontakt	uppgift
kontaktväg	kontakt	väg
kontantlöst	kontantlös	t
kontinuerligt	kontinuerlig	t
kontorist	kontor	ist
kontorsbyggnad	kontor	s	byggnad
kontorsflicka	kontor	s	flicka
kontorsslav	kontor	s	slav
kontrastera	kontrast	era
kontrollavgift	kontroll	avgift
kontrollera	kontroll	era
kontrollmedel	kontroll	medel
kontrollrum	kontroll	rum
kontroversiellt	kontroversiell	t
konturera	kontur	era
koordinering	koordinera	ing
kopiering	kopiera	ing
koppling	koppla	ing
korrekturläsare	korrekturläsa	are
korsning	korsa	ning
korttidspermittering	korttidspermittera	ing
kortvarigt	kortvarig	t
korvbröd	korv	bröd
korvgubbe	korv	gubbe
korvkiosk	korv	kiosk
korvskiva	korv	skiva
kostnad	kosta	nad
kostnadsökning	kostnad	s	ökning
kostrådgivning	kost	rådgivning
kostsam	kost	sam
kostsamt	kostsam	t
kraftfullt	kraftfull	t
kraftig	kraft	ig
kraftigt	kraftig	t
krampaktigt	krampaktig	t
kranbil	kran	bil
kranbilsförare	kranbil	s	förare
kreativt	kreativ	t
kreditera	kredit	era
kreditering	kreditera	ing
kremering	kremera	ing
kretsloppscirkel	kretslopp
krigare	kriga	are
krigsdekoration	krig	s	dekoration
krigsman	krig	s	man
krisgrupp	kris	grupp
krishantera	kris	hantera
krishantering	krishantera	ing
krisinformation	kris	information
krismöte	kris	möte
krispighet	krispig	het
kristallform	kristall	form
kristallisera	kristall	isera
kritikermässig	kritiker	mässig
kritiskt	kritisk	t
krokig	krok	ig
krokighet	krokig	het
kronologiskt	kronologisk	t
kroppsarbeta	kropp	arbeta
kroppsdel	kropp	s	del
kroppshydda	kropp	s	hydda
kroppslängd	kropp	längd
kroppsspråk	kropp	s	språk
kroppsvätska	kropp	s	vätska
kroppsvård	kropp	s	vård
kryddighet	kryddig	het
kryddning	krydda	ning
krympflation	krympa	inflation
kryssare	kryssa	are
krämig	kräm	ig
krängning	kränga	ning
kränkning	kränka	ning
krångligt	krånglig	t
kulinariskt	kulinarisk	t
kulturantropologi	kultur	antropologi
kulturarbetare	kultur	arbetare
kulturchef	kultur	chef
kulturdebatt	kultur	debatt
kulturellt	kulturell	t
kulturförening	kultur	förening
kulturförmedlare	kultur	förmedlare
kulturhistoriskt	kulturhistorisk	t
kulturminister	kultur	minister
kulturpolitiker	kultur	politiker
kulturuttryck	kultur	uttryck
kulturvetenskap	kultur	vetenskap
kulturvetenskaplig	kulturvetenskap	lig
kundgrupp	kund	grupp
kundkrets	kund	krets
kundprojekt	kund	projekt
kundtidning	kund	tidning
kundtjänstmedarbetare	kundtjänst	medarbetare
kundupplevelse	kund	upplevelse
kunglig	kung	lig
kunglighet	kunglig	het
kungsfiskare	kung	fiskare
kungsfågel	kung	fågel
kungstanke	kung	s	tanke
kunnigt	kunnig	t
kunskapsbank	kunskap	s	bank
kunskapsmässigt	kunskapsmässig	t
kunskapsnivå	kunskap	s	nivå
kurera	kur	era
kursare	kursa	are
kurskamrat	kurs	kamrat
kursledare	kurs	ledare
kursupplägg	kurs	upplägg
kursutbud	kurs	utbud
kusligt	kuslig	t
kustbana	kust	bana
kusthav	kust	hav
kvackare	kvacka	are
kvadratkilometer	kvadrat	kilometer
kvalificering	kvalificera	ing
kvalitetskontrollera	kvalitetskontroll	era
kvalitetsmässig	kvalitet	s	mässig
kvalitetsprodukt	kvalitet	s	produkt
kvalitetssäkrare	kvalitetssäkra	are
kvantitativt	kvantitativ	t
kvartalskapitalism	kvartal	s	kapitalism
kvarting	kvarta	ing
kvickhet	kvick	het
kvinnlig	kvinna	lig
kvinnoroll	kvinna	roll
kvotering	kvotera	ing
kväljning	kvälja	ning
kvällspromenad	kväll	s	promenad
kycklingbuljong	kyckling	buljong
kycklingfilé	kyckling	filé
kycklingkött	kyckling	kött
kycklingmage	kyckling	mage
kycklingsallad	kyckling	sallad
kylare	kyla	are
kylig	kyl	ig
kyrkby	kyrka	by
kyrklig	kyrka	lig
kyrkogård	kyrka	gård
kyrkopolitiskt	kyrkopolitisk	t
källarmoské	källare	moské
källbelägga	källa	belägga
källhänvisning	hänvisning
källtillit	källa	nödläge
kännare	känna	are
kännbar	känna	bar
känslighet	känslig	het
kärleksdikt	kärlek	s	dikt
kärleksfull	kärlek
kärlekskrank	kärlek	s
kärleksroman	kärlek	s	roman
kärlig	kärl	ig
kärnkraftsavfall	kärnkraft	s	avfall
kärnkraftspolitik	kärnkraft	s	politik
kärnvapenmakt	kärnvapen	makt
kåthet	kåt	het
kökschef	kök	s	chef
kökspojke	kök	s	pojke
köksö	kök	ö
könsdysforidiagnos	könsdysfori	diagnos
könsdysforiutredning	könsdysfori	utredning
köpare	köpa	are
köping	köpa	ing
körkortsinnehavare	körkort	s	innehavare
körkortsutbildning	körkort	s	utbildning
körning	köra	ning
körsbärsträd	körsbär	s	träd
köttbuljong	kött	buljong
köttermometer	kött	termometer
köttfärs	kött	färs
köttfärsbiff	köttfärs	biff
köttfärslimpa	köttfärs	limpa
köttfärspaj	köttfärs	paj
köttfärssås	köttfärs	sås
köttgryta	kött	gryta
kötthammare	kött	hammare
köttig	kött	ig
köttkniv	kött	kniv
köttkvarn	kött	kvarn
köttnationalism	kött
köttros	kött
köttvara	kött	vara
lackera	lack	era
laddare	ladda	are
laddning	ladda	ning
lagerarbetare	lager	arbetare
lagföring	lagföra	ing
lagligt	laglig	t
laglöshet	laglös	het
lagman	lag	man
lagstadga	lag	stadga
lagstiftare	lagstifta	are
lagstiftning	lagstifta	ning
laktosfri	laktos	fri
lammkotlett	lamm	kotlett
lammrätt	lamm	rätt
lammstek	lamm	stek
landning	landa	ning
landningsbana	landning	s	bana
landrötning	land	rötning
landsflyktig	landsflykt	ig
landsförvisning	landsförvisa	ning
landskapsblomma	landskap	s	blomma
landskapsdjur	landskap	s	djur
landskapsfisk	landskap	s	fisk
landskapsmålare	landskap	s	målare
landskommun	land	s	kommun
landslag	land	s	lag
landstigning	landstiga	ning
landstingspolitiker	landsting	s	politiker
landvind	land	vind
landvinning	land	vinning
lansera	lans	era
lansering	lansera	ing
lantbrukshögskola	lantbruk	s	högskola
lappsjuka	lapp	sjuka
larmrapport	larm	rapport
larvig	larv	ig
lasagneplatta	lasagne	platta
laserskiva	laser	skiva
lastbil	last	bil
lastbilschaufför	lastbil	s	chaufför
lastbilsförare	lastbil	s	förare
lastbilshytt	lastbil	s	hytt
lastbilskörkort	lastbil	s	körkort
lastbilsmekaniker	lastbil	s	mekaniker
lastbilstillverkare	lastbil	s	tillverkare
lastbilstrafik	lastbil	s	trafik
lastfrånskiljare	last	frånskiljare
lastning	lasta	ning
latinlärare	latin	lärare
laxera	lax	era
ledare	leda	are
ledig	led	ig
ledighet	ledig	het
ledning	leda	ning
ledningskompetens	ledning	s
ledsagare	ledsaga	are
ledsam	led	sam
ledsamhet	ledsam	het
ledsjukdom	led	sjukdom
legering	legera	ing
lekare	leka	are
lekpark	lek	park
leksakståg	leksak	s	tåg
lesserwisser	little	besserwisser
leverera	lever	era
leverpastej	lever	pastej
lexikografiskt	lexikografisk	t
liberalteolog	liberal	teolog
libertarianism	libertarian	ism
liggare	ligga	are
likformighet	likformig	het
likgiltighet	likgiltig	het
likhet	lik	het
likhetstecken	likhet	s	tecken
likviditetsbudget	likviditet
likvärdighet	likvärdig	het
likvärdigt	likvärdig	t
lindrigt	lindrig	t
lingonsylt	lingon	sylt
linjelopp	linje	lopp
linssallad	lins	sallad
lirare	lira	are
listig	list	ig
listning	lista	ning
litauiskfödd	litauisk	född
litteraturforskare	litteratur	forskare
litteraturhistoriker	litteratur	historiker
litteraturhistoriskt	litteraturhistorisk	t
litteraturprofessor	litteratur
litteraturstudent	litteratur	student
litteraturstudie	litteratur	studie
litteraturvetenskap	litteratur	vetenskap
livlig	liv	lig
livlighet	livlig	het
livmoder	liv	moder
livsdag	liv	s	dag
livsfarligt	livsfarlig	t
livskamrat	liv	s	kamrat
livsmedelsbutik	livsmedel	s	butik
livsmedelsindustri	livsmedel	s	industri
livvakt	liv	vakt
ljudfil	ljud	fil
ljudinspelning	ljud	inspelning
ljudmässig	ljud	mässig
ljudstyrka	ljud	styrka
ljuspenna	ljus	penna
ljuspunkt	ljus	punkt
ljusstark	ljus	stark
ljust	ljus	t
ljusår	ljus	år
ljuvlighet	ljuvlig	het
ljuvligt	ljuvlig	t
lokalanställd	lokal
lokalbedövning	lokalbedöva	ning
lokalnyhet	lokal	nyhet
lokalpolisområde	lokal
lokalt	lokal	t
loppisbesökare	loppis	besökare
lotsning	lotsa	ning
lottlös	lott	lös
lottning	lotta	ning
luffare	luffa	are
luftangrepp	luft	angrepp
luftballong	luft	ballong
luftfartyg	luft	fartyg
luftförorening	luft	förorening
luftig	luft	ig
luftrör	luft	rör
lufttemperatur	luft	temperatur
luftväg	luft	väg
luktfri	lukt	fri
lunchlåda	lunch	låda
lustig	lust	ig
lutning	luta	ning
lyckligtvis	lycklig	t	vis
lyckönskning	lyckönska	ning
lysning	lysa	ning
lyssnare	lyssna	are
läckerhet	läcker	het
lägenhetshus	lägenhet	s	hus
lägenhetskontrakt	lägenhet	s	kontrakt
lägerskola	läger	skola
läggning	lägga	ning
läkare	läka	are
läkarundersökning	läkarundersöka	ning
läkemedel	läka	medel
läkemedelskemist	läkemedel	s	kemist
läkemedelstillverkare	läkemedel	s	tillverkare
lämplighet	lämplig	het
lämpligt	lämplig	t
längtansfullt	längtansfull	t
länkning	länka	ning
länsman	län	man
länssjukhus	län	s	sjukhus
länsveterinär	län	s	veterinär
länsvis	län	s	vis
lärare	lära	are
lärlingsperiod	lärling	s	period
lärlingsplats	lärling	s	plats
läsare	läsa	are
läsbar	läsa	bar
läsbarhet	läsbar	het
läskig	läsk	ig
läsning	läsa	ning
läsplatta	läsa	platta
läsårsstart	läsår	s	start
lätting	lätta	ing
lättnad	lätta	nad
lättsam	lätta	sam
lådvin	låda	vin
lågspänning	låg	spänning
lågspänningskabel	lågspänning	s	kabel
låneperiod	lån	period
långhårig	lång	hårig
långledig	lång	ledig
långsamt	långsam	t
långsiktighet	långsiktig	het
långsiktigt	långsiktig	t
långtråkigt	långtråkig	t
låskolv	lås	kolv
låsring	lås	ring
lögnkampanj	lögn	kampanj
löjlig	löja	lig
löjligt	löjlig	t
lökblast	lök	blast
lökig	lök	ig
lönearbeta	lön	arbeta
lönebidragsanställning	lönebidrag	s	anställning
löneförhöjning	lön	e	förhöjning
lönespecifikation	lön	e	specifikation
löneuppgift	lön	e	uppgift
lönnmördare	lönnmörda	are
lönsam	lön	sam
lönsamhet	lönsam	het
löpare	löpa	are
löparstjärna	löpare	stjärna
löpning	löpa	ning
löptid	löpa	tid
lördagsgodis	lördag	godis
lördagskväll	lördag	s	kväll
lösning	lösa	ning
madrassera	madrass	era
magasinera	magasin	era
magisterexamen	magister	examen
magnetisera	magnet	isera
majsgröt	majs	gröt
makalös	maka	lös
makalöst	makalös	t
maktbalans	makt	balans
maktblock	makt	block
maktfördelning	makt	fördelning
maktkamp	makt	kamp
mallig	mall	ig
malmfyndighet	malm	fyndighet
malmkropp	malm	kropp
mandatmässig	mandat	mässig
mandelmjöl	mandel	mjöl
manlig	man	lig
manodepressivt	manodepressiv	t
mansdominerad	man	dominera
mantalsskrivning	mantalsskriva	ning
manusförfattare	manus	författare
mardrömsbyråkrati	mardröm
mardrömsorganisation	mardröm
marginalisera	marginal	isera
marinera	marin	era
marinmålare	marin	målare
markering	markera	ing
marknadsanalytiker	marknad	s	analytiker
marknadsförare	marknadsföra	are
marknadsföring	marknadsföra	ing
marknadsföringssyfte	marknadsföring	s	syfte
marknadsförändring	marknad	s	förändring
marknadskommunikatör	marknad	s	kommunikatör
marknadsmissbruk	marknad
marknadsplats	marknad	s	plats
marknadsundersökning	marknad	s	undersökning
marknadsvärde	marknad
marschera	marsch	era
maskera	mask	era
maskinist	maskin	ist
maskinmontör	maskin	montör
maskinmässig	maskin	mässig
maskinspråk	maskin	språk
maskrosbarn	maskros	barn
massinvandring	invandring
massivt	massiv	t
matare	mata	are
matavfall	mat	avfall
matblogg	mat	blogg
matbloggerska	mat	bloggerska
matbord	mat	bord
matbröd	mat	bröd
matbutik	mat	butik
matbutikskedja	matbutik	s	kedja
matchning	matcha	ning
matematiklärare	matematik	lärare
materialism	material	ism
materialist	material	ist
materialåtervinna	material	återvinna
matfett	mat	fett
matfisk	mat	fisk
mathistoriker	mat	historiker
matig	mat	ig
matkasse	mat	kasse
matkreatör	mat	kreatör
matkultur	mat	kultur
matlagningsgrädde	matlagning	s	grädde
matlagningsvin	matlagning	s	vin
matlåda	mat	låda
matolja	mat	olja
matsal	mat	sal
matsmältningsorgan	matsmältning	s	organ
matstrejka	mat	strejka
matsvamp	mat	svamp
matsäck	mat	säck
matteprov	matte	prov
mattidning	mat	tidning
medborgarinsyn	medborgare	insyn
medelhöjd	medel	höjd
medelklassförort	medelklass	förort
medelsanvisning	medel	s	anvisning
medeltemperatur	medel	temperatur
medelväg	väg
medelvärde	medel	värde
medgörligt	medgörlig	t
medicinera	medicin	era
medlare	medla	are
medlemsavgift	medlem	s	avgift
medlemsmöte	medlem	s	möte
medvetenhet	medveten	het
megafon	mega	fon
mellanrum	mellan	rum
meningsfullt	meningsfull	t
meningslöst	meningslös	t
mensblod	mens	blod
menskonst	mens	konst
menskopp	mens	kopp
meritera	merit	era
meritokratiskt	meritokratisk	t
mesig	mes	ig
meta-tagg	meta	tagg
metallarbetare	metall	arbetare
metallföremål	metall	föremål
metallsökare	metall
metare	meta	are
meteorologiskt	meteorologisk	t
metodiskt	metodisk	t
metspö	meta	spö
midsommarblomster	sommar
migrationsvåg	migration	s	våg
mikrobiologiskt	mikrobiologisk	t
militärkapten	militär	kapten
militärpolis	militär	polis
miljöanläggning	miljö	anläggning
miljöanpassning	miljö	anpassning
miljöbil	miljö	bil
miljöbrott	miljö	brott
miljödomstol	miljö	domstol
miljöeffekt	miljö	effekt
miljöforskare	miljö	forskare
miljöfråga	miljö	fråga
miljöfördel	miljö	fördel
miljöhandläggare	miljö	handläggare
miljöinspektör	miljö	inspektör
miljöklass	miljö	klass
miljökonsekvensbeskrivning	miljökonsekvens	beskrivning
miljömässig	miljö	mässig
miljöplanerare	miljö	planerare
miljöpolitik	miljö	politik
miljöpåfrestning	miljö	påfrestning
miljörörelse	miljö	rörelse
miljöskadlig	miljöskada	lig
miljöskatt	miljö	skatt
miljöskäl	miljö	skäl
miljöstation	miljö	station
miljöstrateg	miljö	strateg
miljöåklagare	miljö	åklagare
miljöåtgärd	miljö	åtgärd
mindorobuffel	Mindoro	buffel
ministerstyrelse	minister	styrelse
minnesgåva	minne	s	gåva
minneskonstnär	minne	s	konstnär
minneslund	minne	lund
minnessten	minne	s	sten
minoritetsgrupp	minoritet	s	grupp
minskning	minska	ning
missbrukare	miss	brukare
missionshus	mission	s	hus
misstroendeförklaring	misstroendeförklara	ing
misstänksam	misstänka	sam
misstänksamhet	misstänksam	het
missuppfattning	-ning
mittemellan	mitt
mjukhet	mjuk	het
mjölig	mjöl	ig
mjölkdisk	mjölk	disk
mjölkfri	mjölk	fri
mjölkkanal	mjölk	kanal
mjölkkanna	mjölk	kanna
mjölkmaskin	mjölk	maskin
mjölkpiga	mjölk	piga
mjölkproteinfri	mjölkprotein	fri
mjölkpulver	mjölk	pulver
mjölsäck	mjöl	säck
mobbning	mobba	ning
mobilberoende	mobil	beroende
mobilisering	mobilisera	ing
mobilmast	mobil	mast
mobiltelefon	mobil	telefon
modebutik	mode	butik
modellera	modell	era
modellering	modellera	ing
modellsnickare	modell	snickare
modemässig	mode	mässig
modeord	mode	ord
moderbolag	moder	bolag
moderera	moder	era
moderlig	moder	lig
modernisera	modern	isera
modernisering	modernisera	ing
modernism	modern	ism
modernist	modern	ist
modernt	modern	t
modetidning	mode	tidning
modifiering	modifiera	ing
modulera	modul	era
modulering	modulera	ing
molnig	moln	ig
momsavdrag	moms	avdrag
momshöjning	moms	höjning
monarkist	monark	ist
monopolisera	monopol	isera
monopolist	monopol	ist
montering	montera	ing
mopedist	moped	ist
moralisera	moral	isera
moraliskt	moralisk	t
moralist	moral	ist
mordoffer	mord	offer
morfar	mor	far
morgongåva	morgon	gåva
morgonrock	morgon	rock
morgontidning	morgon	tidning
morsgris	mor	s	gris
moskébesökare	moské	besökare
moskébyggnad	moské	byggnad
motionera	motion	era
motionscentral	motion	s	central
motionsslinga	motion	s	slinga
motionsutlåtande	motion	s	utlåtande
motivera	motiv	era
motivering	motivera	ing
motorfordon	motor	fordon
motståndskabaré	motstånd
motståndskraft	motstånd	s	kraft
motståndskraftig	motståndskraft	ig
motståndsrörelse	motstånd	s	rörelse
motsättning	motsätta	ning
mottagare	mottaga	are
mottagning	mottaga	ning
mottagningshall	mottagning	s	hall
munhygien	mun	hygien
munhygienist	munhygien	ist
munkorg	mun	korg
muntligt	muntlig	t
murare	mura	are
musikfolkhögskola	musik	folkhögskola
musikforskare	musik	forskare
musikförlag	musik	förlag
musikgrupp	musik	grupp
musikhögskola	musik	högskola
musikjournalist	musik	journalist
musiklärare	musik	lärare
musiklärarinna	musik	lärarinna
musikpedagog	musik	pedagog
musikproducent	musik	producent
musikstudent	musik	student
musikterapeut	musik	terapeut
musikvetenskap	musik	vetenskap
muskotnöt	muskot	nöt
mustig	must	ig
myggfri	mygg	fri
myglare	mygla	are
myndighet	myndig	het
myndighetsbeslut	myndighet	s	beslut
myndighetsdag	myndighet	s	dag
myndighetsdokument	myndighet	s	dokument
myndigt	myndig	t
mysig	mys	ig
mytologiskt	mytologisk	t
mäklare	mäkla	are
mäktighet	mäktig	het
mänsklig	mänska	lig
mänsklighet	mänsklig	het
märkbar	märka	bar
märkesman	märke	s	man
märklighet	märklig	het
märkligt	märklig	t
märkning	märka	ning
märkvärdighet	märkvärdig	het
mästerkock	mästere
mätare	mäta	are
mätbar	mäta	bar
mätning	mäta	ning
mätvärde	värde
målare	måla	are
målchans	mål	chans
målmässig	mål	mässig
målning	måla	ning
måltavla	mål	tavla
måltid	mål	tid
måltidsdryck	måltid	s	dryck
månadslön	månad	lön
månadstidskrift	månad	s	tidskrift
mångfasetterad	mången	fasetterad
mångsidighet	mångsidig	het
mångsidigt	mångsidig	t
mårddjur	mård	djur
måttlig	mått	lig
möbelbutik	möbel	butik
möbelföretag	möbel	företag
mödom	mö	dom
mödomshinna	mödom	s	hinna
mödosamt	mödosam	t
möjlighet	möjlig	het
möjligt	möjlig	t
möjligtvis	möjlig	t	vis
mönsterelev	mönster	elev
mördare	mörda	are
mörklägga	mörk	lägga
mörkläggning	mörklägga	ning
mötesarrangör	möte	s	arrangör
mötesrum	möte	s	rum
mötessekreterare	möte	s	sekreterare
nagelteknolog	nagel	teknolog
naivist	naiv	ist
naivt	naiv	t
nakenstrand	naken	strand
namngivare	namngiva	are
namngivning	namngiva	ning
namnlös	namn	lös
narkotikapolis	narkotika	polis
narkotikapolitik	narkotika	politik
narkotikasmugglare	narkotika	smugglare
nattborgmästare	natt	borgmästare
nattlig	natt	lig
nattpåse	natt	påse
naturgas	natur	gas
naturgasfyndighet	fyndighet
naturgasledning	naturgas	ledning
naturgasproducent	naturgas	producent
naturkatastrof	natur	katastrof
naturlig	natur	lig
naturligt	naturlig	t
naturligtvis	naturligt	vis
naturmänniska	natur	människa
naturtyp	natur	typ
naturvetenskaplig	naturvetenskap	lig
navigering	navigera	ing
nedläggning	nedlägga	ning
neutralt	neutral	t
nickning	nicka	ning
nigning	niga	ning
nikotinist	nikotin	ist
nikotinprodukt	nikotin	produkt
njutbar	njuta	bar
njutning	njuta	ning
noggrannhet	noggrann	het
noggrannt	noggrann	t
nollutsläpp	noll	utsläpp
nollvision	noll	vision
nollåtta	noll	åtta
nomadisera	nomad	isera
nominalist	nominal	ist
nominering	nominera	ing
nordatlantisk	nord	atlantisk
nordist	nord	ist
nordlig	nord	lig
normalbild	normal	bild
normalt	normal	t
normera	norm	era
norskfödd	norsk	född
norskspråkig	norsk	språkig
nostalgiskt	nostalgisk	t
notera	not	era
notering	notera	ing
novellist	novell	ist
novent	advent	november
nyanländ	ny	anländ
nyansera	nyans	era
nyansering	nyansera	ing
nyanställning	nyanställa	ning
nybildning	nybilda	ning
nyckelaktör	nyckel	aktör
nyckelbarn	nyckel	barn
nyckelegenskap	nyckel	egenskap
nyckelharpa	nyckel	harpa
nyckelkund	nyckel	kund
nyckelman	nyckel	man
nyckelord	nyckel	ord
nyckelperson	nyckel	person
nyckelroman	nyckel	roman
nyhet	ny	het
nykterhet	nykter	het
nykterhetsförening	nykterhet	s	förening
nykterhetskontroll	nykterhet	s	kontroll
nykterhetsorganisation	nykterhet	s	organisation
nykterhetspolitik	nykterhet	s	politik
nykterist	nykter	ist
nyrekrytering	ny
nysning	nysa	ning
nystartad	ny	starta
nytjärad	ny	tjärad
nyttighet	nyttig	het
nyår	ny	år
nyårsfirande	nyår	s	firande
näring	nära	ing
näringslivsorganisation	näringsliv	s	organisation
näringsmässigt	näringsmässig	t
näringsvärde	näring	s	värde
närpolischef	närpolis
närståendepenning	närstående	penning
nättjänst	nät	tjänst
nådeansökan	nåd	e	ansökan
nödläge	nöd	läge
nödsamtal	nöd	samtal
nödvändighet	nödvändig	het
nödvändigtvis	nödvändig	t	vis
nöjesliv	nöje	s	liv
nötkött	nöt	kött
oacceptabel	o	acceptabel
oansvarig	o	ansvarig
oanträffbar	o	anträffbar
oanvändbar	o	användbar
oaptitlig	o	aptitlig
oartig	o	artig
oavhängig	o	avhängig
oavsedd	o	avsedd
oavsiktlig	o	avsiktlig
oavsiktligt	oavsiktlig	t
obarmhärtig	o	barmhärtig
obarmhärtigt	obarmhärtig	t
obeboelig	o	beboelig
obefintlig	o	befintlig
obegriplig	o
obegriplighet	obegriplig	het
obegripligt	obegriplig	t
obegåvad	o	begåvad
obehaglig	o	behaglig
obehagligt	obehaglig	t
obekväm	o	bekväm
obekvämt	obekväm	t
obenägen	o	benägen
oberoende	o	beroende
oberättigad	o	berättigad
obeskrivbart	obeskrivbar	t
obeslutsam	o	beslutsam
obestämd	o	bestämd
obetydlig	o	betydlig
obevakad	o	bevakad
obildad	o	bildad
obligatoriskt	obligatorisk	t
obunden	o	bunden
odaterad	o	daterad
odelbar	o	delbar
odemokratisk	o	demokratisk
odemokratiskt	odemokratisk	t
odlare	odla	are
odling	odla	ing
odramatisk	o	dramatisk
odödlig	o	dödlig
oemotståndligt	oemotståndlig	t
oenhetlig	o	enhetlig
oerfaren	o	erfaren
oetisk	o	etisk
ofarlig	o	farlig
ofattbart	ofattbar	t
offentlighet	offentlig	het
officiellt	officiell	t
ofrivillig	o	frivillig
ofrivilligt	ofrivillig	t
ofruktsam	o	fruktsam
ofullbordad	o	fullbordad
ofullgången	o	fullgången
ofullkomlig	o	fullkomlig
ofullständig	o	fullständig
ofördelaktig	o	fördelaktig
ofördelaktighet	ofördelaktig	het
oförenlig	o	förenlig
oförklarligt	oförklarlig	t
oförmåga	o	förmåga
oföränderlig	o	föränderlig
ogenomskinlig	o	genomskinlig
ogift	o	gift
ogiltig	o	giltig
ogiltigförklaring	ogiltigförklara	ing
ohederlig	o	hederlig
ohederligt	ohederlig	t
ohyggligt	ohygglig	t
ohållbar	o	hållbar
ohållbarhet	o	hållbarhet
ojämförbar	o	jämförbar
ojämlik	o	jämlik
ojämlikhet	ojämlik	het
ojämn	o	jämn
ojämställd	o	jämställd
oklar	o	klar
oklarhet	oklar	het
okontrollerad	o	kontrollerad
okontrollerbart	okontrollerbar	t
okontroversiell	o	kontroversiell
okontroversiellt	okontroversiell	t
okunnig	o	kunnig
okunnighet	okunnig	het
okunnigt	okunnig	t
okvinnlig	o	kvinnlig
okänd	o	känd
okänslig	o	känslig
olaglig	o	laglig
olaglighet	olaglig	het
olik	o	lik
olikartad	o	likartad
olikhet	olik	het
olivolja	oliv	olja
ollonbroder	ollon	broder
ologisk	o	logisk
olycklig	o	lycklig
olyckligt	olycklig	t
olyckligtvis	olycklig	t	vis
olämplig	o	lämplig
olämpligt	o	lämpligt
olönsam	o	lönsam
omarbeta	om	arbeta
ombilda	om	bilda
ombildning	ombilda	ning
ombudsman	ombud	man
omdekorera	om	dekorera
omdirigera	om	dirigera
omdirigering	omdirigera	ing
omdisponera	om	disponera
omfamna	om	famna
omfatta	om	fatta
omfattning	omfatta	ning
omforma	om	forma
omformare	omforma	are
omformulera	om	formulera
omfördela	om	fördela
omfördelning	omfördela	ning
omförhandla	om	förhandla
omge	om	ge
omgiva	om	giva
omgivning	omgiva	ning
omkasta	om	kasta
omklassificera	om	klassificera
omkomma	om	komma
omnämna	om	nämna
omogen	o	mogen
omoralisk	o	moralisk
omorganisera	om	organisera
omplacera	om	placera
omprogrammera	om	programmera
ompröva	om	pröva
omprövning	ompröva	ning
omringa	om	ringa
områdespolis	område	s	polis
omskola	om	skola
omskolning	omskola	ning
omslagsflicka	omslag	s	flicka
omsluta	om	sluta
omslutning	omsluta	ning
omstrukturera	om	strukturera
omstrukturering	omstrukturera	ing
omställa	om	ställa
omställning	omställa	ning
omsätta	om	sätta
omsättning	omsätta	ning
omtala	om	tala
omtenta	om	tenta
omvandling	omvandla	ing
omvälja	om	välja
omvärdera	om	värdera
omvärdering	omvärdera	ing
omväxla	om	växla
omväxling	omväxla	ing
omyndig	o	myndig
omänsklig	o	mänsklig
omöjlig	o	möjlig
omöjligt	omöjlig	t
onaturlig	o	naturlig
onoterad	o	noterad
onyttig	o	nyttig
onödighet	onödig	het
onödigt	onödig	t
opartiskhet	opartisk	het
operahögskola	opera	högskola
operamässig	opera	mässig
operationskniv	operation	s	kniv
operettsällskap	operett	sällskap
opersonlig	o	personlig
opinionsartikel	opinion	s	artikel
opinionsjournalistik	opinion	s	journalistik
opolitisk	o	politisk
oppositionstidning	opposition	s	tidning
optimering	optimera	ing
optimistiskt	optimistisk	t
opublicerad	o	publicerad
opålitlig	o	pålitlig
ordbok	ord	bok
ordentligt	ordentlig	t
orderhantering	order	hantering
orderingång	order	ingång
ordförandeland	ordförande	land
ordklass	ord	klass
ordkonstnär	ord	konstnär
ordlek	ord	lek
ordningsam	ordning	sam
ordningsfråga	ordning	s	fråga
ordningslag	ordning	s	lag
ordningsvakt	ordning	s	vakt
oregelbunden	o	regelbunden
oregelbundenhet	oregelbunden	het
organhandel	organ	handel
organisationsenhet	organisation	s	enhet
organisera	organ	isera
organism	organ	ism
organist	organ	ist
orienterare	orientera	are
orientering	orientera	ing
orimlig	o	rimlig
orimligt	orimlig	t
orolig	o	rolig
orolighet	orolig	het
oroväckande	oro
orättvis	o	rättvis
orättvist	orättvis	t
orörlig	o	rörlig
orörligt	orörlig	t
osaklig	o	saklig
osaltad	o	saltad
osedvanlig	o
osentimental	o	sentimental
osexig	o	sexig
osjälvisk	o	självisk
osjälvständig	o	självständig
oskicklig	o	skicklig
oskuldsoperation	oskuld	s	operation
oskyldig	o	skyldig
oskyldigt	oskyldig	t
osmaklig	o	smaklig
ostkaka	ost	kaka
ostridigt	ostridig	t
ostronkniv	ostron	kniv
ostronöppnare	ostron	öppnare
osynlig	o	synlig
osäker	o	säker
osäkerhet	osäker	het
otillgänglig	o	tillgänglig
otillräcklig	o	tillräcklig
otrevlig	o	trevlig
otrevlighet	otrevlig	het
otrevligt	otrevlig	t
otroligt	o	troligt
otvetydig	o	tvetydig
otydlig	o	tydlig
otänkbar	o	tänkbar
oundviklig	o	undviklig
outnyttjad	o	utnyttjad
outvecklad	o	utveckla
ovan	o	van
ovanlig	o	vanlig
ovanligt	ovanlig	t
overklig	o	verklig
ovetenskaplig	o	vetenskaplig
ovetenskapligt	ovetenskaplig	t
oviktig	o	viktig
oväntad	o	väntad
ovärdig	o	värdig
oväsentlig	o	väsentlig
oväsentlighet	oväsentlig	het
oxygenbrist	oxygen	brist
oändlighet	oändlig	het
oändligt	oändlig	t
oåtkomlig	o	åtkomlig
oåtkomligt	oåtkomlig	t
oönskad	o	önskad
padelanläggning	padel	anläggning
padelhall	padel	hall
padelspelare	padel	spelare
padelturnering	padel	turnering
padeltävling	padel	tävling
pajdeg	paj	deg
pajform	paj	form
paketera	paket	era
paleoantropologiskt	paleoantropologisk	t
palestinskfödd	palestinsk	född
panering	panera	ing
pantsättare	pantsätta	are
pappavecka	pappa	vecka
pappershandduk	papper	s	handduk
pappersindustri	papper	s	industri
papperskniv	papper	s	kniv
papperstidning	papper	tidning
papperstiger	papper	s	tiger
parafrasera	parafras	era
paragrafryttare	paragraf	ryttare
parallellt	parallell	t
paraplybegrepp	paraply	begrepp
parkarbetare	park	arbetare
parkera	park	era
parkering	parkera	ing
parkeringshus	parkering	s	hus
parkeringsplats	parkering	s	plats
parkeringsvakt	parkering	s	vakt
parkeringsvaktsutbildning	parkeringsvakt	s	utbildning
parkettbiljett	parkett	biljett
parkettgolv	parkett	golv
parlamentariskt	parlamentarisk	t
parlamentsledamot	parlament	s	ledamot
parning	para	ning
partibidrag	parti	bidrag
partikongress	parti	kongress
partiledare	parti	ledare
partiledning	parti	ledning
partilös	parti	lös
partiomröstning	parti	omröstning
partipolitiskt	partipolitisk	t
partistyrelse	parti	styrelse
partisympati	parti	sympati
partisympatiundersökning	partisympati	undersökning
partivalsedel	parti	valsedel
passare	passa	are
passavdelning	pass	avdelning
passbyrå	pass	byrå
passivisera	passiv	isera
passivt	passiv	t
passning	passa	ning
pastasås	pasta	sås
pastörisering	pastörisera	ing
patentera	patent	era
patientsäkerhet	patient	säkerhet
patientsäkerhetslag	patient	säkerhet	s	lag
patrullera	patrull	era
patrullering	patrullera	ing
pedagogiskt	pedagogisk	t
pedofil	-fil
pejling	pejla	ing
pekare	peka	are
pendeltåg	pendel	tåg
pendlare	pendla	are
pendling	pendla	ing
pendlingsförort	pendling	s	förort
pendlingskommun	pendling	s	kommun
pensionera	pension	era
pensionering	pensionera	ing
pensionsförsäkring	pension	s	försäkring
pensling	pensla	ing
pepparkaka	peppar	kaka
periodvis	period	vis
permittering	permittera	ing
personalkostnad	personal
personalmatsal	personal	matsal
personalstyrka	personal	styrka
personalunion	personal	union
personalutbildning	personal	utbildning
personalvård	personal	vård
personlig	person	lig
personlighet	personlig	het
personlighetsförändring	personlighet	s	förändring
personröstning	personrösta	ning
personuppgiftspolicy	personuppgift	s	policy
pianolärarinna	piano	lärarinna
pinsam	pina	sam
pinsamt	pinsam	t
pipare	pipa	are
pissig	piss	ig
pisslön	piss	lön
pistmaskin	pista	maskin
pistolkula	pistol	kula
pivotering	pivotera
placering	placera	ing
planera	plan	era
planerare	planera	are
planering	planera	ing
planlägga	plan	lägga
planläggning	plan	läggning
planlös	plan	lös
planmässig	plan	mässig
plantering	plantera	ing
plastfilm	plast	film
plaståtervinning	plast	återvinning
platsansökan	plats	ansökan
platsbiljett	plats	biljett
plockare	plocka	are
plogbil	plog	bil
plundrare	plundra	are
plundring	plundra	ing
plädera	pläd	era
plötsligt	plötslig	t
poddare	podda	are
poddradio	podd	radio
poetiskt	poetisk	t
polera	pol	era
polisassistent	polis
polisbefäl	polis	befäl
polisbil	polis	bil
polisbuss	polis	buss
polischef	polis	chef
polisdistrikt	polis	distrikt
poliseskort	polis	eskort
polisexamen	polis	examen
polisfordon	polis	fordon
polisförhör	polis	förhör
polishelikopter	polis	helikopter
polishund	polis	hund
polishus	polis	hus
polishäst	polis	häst
polishögskola	polis	högskola
polisinsats	polis	insats
polisinspektör	polis	inspektör
polisintendent	polis	intendent
poliskvinna	polis	kvinna
poliskälla	polis	källa
polislegitimation	polis	legitimation
polismyndighet	polis	myndighet
polisområde	polis	område
polispatrull	polis	patrull
polispådrag	polis	pådrag
polisregion	polis	region
polisskola	polis	skola
polisstation	polis	station
polisstudent	polis	student
polistaleskvinna	polis	taleskvinna
polisuniform	polis	uniform
polisutredning	polis	utredning
polisärende	polis	ärende
politiskt	politisk	t
pollettera	pollett	era
pollettering	pollettera	ing
pollinering	pollinera	ing
polskfödd	polsk	född
popcornhjärna	popcorn	hjärna
popupkampanj	popup	kampanj
porträttera	porträtt	era
portugisiskspråkig	portugisisk	språkig
positionera	position	era
postadress	post	adress
potatisbulle	potatis	bulle
potatischips	potatis	chips
potatisgratäng	potatis	gratäng
potatiskaka	potatis	kaka
potatisklyfta	potatis	klyfta
potatiskällare	potatis	källare
potatismjöl	potatis	mjöl
potatismos	potatis	mos
potatisodlare	potatis	odlare
potatisplanta	potatis	planta
potatissallad	potatis	sallad
potatisskalare	potatis	skalare
potatisväxt	potatis	växt
potatisåker	potatis	åker
potentiellt	potentiell	t
poängmässig	poäng	mässig
poängsättning	poängsätta	ning
poängtips	poäng	tips
praktisera	prakt	isera
praktiskt	praktisk	t
pratsam	prat	sam
premiärlöjtnant	premiär	löjtnant
prenumerant	prenumerera	-ant
presentationsteknik	presentation
presentera	present	era
presidentfru	president	fru
presidentkandidat	president	kandidat
presidentperiod	president	period
presidentval	president	val
presskort	press	kort
pressträff	press	träff
prestigelöshet	prestigelös	het
prestigelöst	prestigelös	t
pretentiöst	pretentiös	t
prioritering	prioritera	ing
priskategori	pris	kategori
prismässig	pris	mässig
prissätta	pris	sätta
prissättning	prissätta	ning
prisutdelning	pris	utdelning
privatbil	privat	bil
privatbilist	privatbil	ist
privatisera	privat	isera
privatisering	privatisera	ing
privatist	privat	ist
privatkopiering	privat	kopiering
privatkopieringsersättning	privatkopiering	s	ersättning
probiotiskt	probiotisk	t
problembild	problem
problemformulering	problem	formulering
problemfri	problem	fri
problemhäst	problem	häst
produktionsanläggning	produktion	s	anläggning
produktionsapparat	produktion	s	apparat
produktionsenhet	produktion	s	enhet
produktionskostnad	produktion	s	kostnad
produktutveckling	produkt
professionellt	professionell	t
profetera	profet	era
profilera	profil	era
proformafaktura	pro forma	faktura
programmerare	programmera	are
programmering	programmera	ing
programmeringsspråk	programmering	s	språk
projektassistent	projekt	assistent
projektchef	projekt	chef
projektdeltagare	projekt	deltagare
projektera	projekt	era
projektgrupp	projekt	grupp
projektledare	projekt	ledare
propagandakrig	propaganda	krig
propagandaminister	propaganda	minister
prosaarbete	prosa	arbete
proteinfri	protein	fri
proteinhaltig	proteinhalt	ig
protestantism	protestant	ism
protestera	protest	era
provanställning	prov	anställning
provinstidning	provins	tidning
provning	prova	ning
provpitcha	prov	pitcha
provrörsbarn	provrör	s	barn
provsmakare	provsmaka	are
prydnad	pryda	nad
prästbostad	präst	bostad
prästkandidat	präst	kandidat
prästvigning	prästviga	ning
prövning	pröva	ning
prövningstillstånd	prövning	tillstånd
pseudovetenskaplig	pseudovetenskap	lig
psykiatriskt	psykiatrisk	t
psykiskt	psykisk	t
psykoanalysera	psykoanalys	era
psykofysiologiskt	psykofysiologisk	t
psykologilärare	psykologi	lärare
psykologisera	psykolog	isera
psykologiskt	psykologisk	t
psykologmottagning	psykolog	mottagning
psykosocialt	psykosocial	t
publicering	publicera	ing
publikmässig	publik	mässig
pulsera	puls	era
pulverisera	pulver	isera
pumpakärna	pumpa	kärna
pumprum	pump	rum
punktera	punkt	era
punktering	punktera	ing
punktlig	punkt	lig
punktmarkering	punktmarkera	ing
pyssling	pyssla	ing
pälsdjur	päls	djur
pälshandlare	päls	handlare
pälsmössa	päls	mössa
påannonsera	påannons	era
påminnelseavgift	påminnelse	avgift
påskbord	påsk	bord
påskris	påsk	ris
påsvin	påse	vin
påverkanskampanj	påverkan	s	kampanj
påverkare	påverka	are
påverkbar	påverka	bar
påvisbar	påvisa	bar
rackare	racka	are
radera	rad	era
radering	radera	ing
radhusförort	radhus	förort
radialborrmaskin	radial	borrmaskin
radikalisera	radikal	isera
radikalisering	radikalisera	ing
radikalt	radikal	t
radiologiskt	radiologisk	t
radiomässig	radio	mässig
radioprogram	radio	program
radiosignal	radio	signal
radioteknik	radio	teknik
raggarbil	raggare	bil
raggare	ragga	are
rakning	raka	ning
ramverk	ram	verk
randig	rand	ig
rankning	ranka	ning
rappare	rappa	are
rappning	rappa	ning
rapportera	rapport	era
rapportering	rapportera	ing
raptext	rap	text
rastlös	rast	lös
rastplats	rast	plats
rationalisering	rationalisera	ing
rationaliseringsundersökning	rationalisering	s	undersökning
rationellt	rationell	t
receptfri	recept	fri
receptionist	reception	ist
redaktionschef	redaktion	s	chef
redigerare	redigera	are
redigering	redigera	ing
redning	reda	ning
redovisning	redovisa	ning
redovisningsekonom	redovisning	s	ekonom
redovisningsperiod	redovisning	s	period
reducering	reducera	ing
reflexmässig	reflex	mässig
reflexmässigt	reflexmässig	t
reformera	reform	era
regelmässig	regel	mässig
regelmässigt	regelmässig	t
regelsystem	regel	system
regeländring	regel	ändring
regering	regera	ing
regeringsbeslut	regering	beslut
regeringsbyggnad	regering	byggnad
regeringschef	regering	chef
regeringsförslag	regering	förslag
regeringskris	regering	kris
regeringsperiod	regering	s	period
regeringsuppdrag	regering	s	uppdrag
regeringsärende	regering	s	ärende
regionalt	regional	t
regionavtal	region	avtal
regionfinal	region
regionpolischef	region
regionsjukhus	region	sjukhus
registrering	registrera	ing
reglerapparat	apparat	regel
reglering	reglera	ing
rehabilitering	re	habilitering
rehabiliteringsersättning	rehabilitering	s	ersättning
rehabiliteringsinsats	rehabilitering	s	insats
rehabiliteringskedja	rehabilitering	kedja
rejält	rejäl	t
reklamera	reklam	era
reklamskrivare	reklam	skrivare
rekordmånga	rekord	många
rekrytera	rekryt	era
rekryterare	rekrytera	are
rekrytering	rekrytera	ing
rekryteringskonsult	rekrytering	s	konsult
rektoskopera	rektoskop	era
relationsroman	relation	s	roman
relativt	relativ	t
religionshistoriker	religion	s	historiker
religionslärare	religion	s	lärare
religionssociologi	religion	s	sociologi
religionsvetenskap	religion	s	vetenskap
rengöring	rengöra	ing
renovering	renovera	ing
replikera	replik	era
reservelverk	reserv	elverk
reservera	reserv	era
reservofficer	reserv	officer
respektera	respekt	era
respektfullt	respektfull	t
respektlös	respekt	lös
respektlöst	respektlös	t
restaurangbyggnad	restaurang	byggnad
restauranghögskola	restaurang	högskola
restaurering	restaurera	ing
restnoterad	rest	noterad
resultatbudget	resultat
resultatmässig	resultat	mässig
resursökning	resurs	ökning
retning	reta	ning
retoriskt	retorisk	t
retsam	reta	sam
revidering	revidera	ing
revisionist	revision	ist
revning	reva	ning
revoltera	revolt	era
revolutionera	revolution	era
riksdagsbeslut	riksdag	s	beslut
riksdagsdebatt	riksdag	s	debatt
riksdagsdirektör	riksdag	s	direktör
riksdagsgrupp	riksdag	s	grupp
riksdagskandidat	riksdag	s	kandidat
riksdagskvinna	riksdag	s	kvinna
riksdagsledamot	riksdag	s	ledamot
riksdagsman	riksdag	s	man
riksdagsmotion	riksdag	s	motion
riksdagsparti	riksdag	s	parti
riksdagsplats	riksdag	s	plats
riksdagspolitiker	riksdag	s	politiker
riksdagsval	riksdag	s	val
riktare	rikta	are
riktigt	riktig	t
riktning	rikta	ning
rimligt	rimlig	t
ringare	ringa	are
risgrynsgröt	risgryn	s	gröt
risig	ris	ig
riskabelt	riskabel	t
riskera	risk	era
riskfri	risk	fri
risknivå	risk	nivå
rismjöl	ris	mjöl
ristning	rista	ning
ritning	rita	ning
rivning	riva	ning
rivningslägenhet	rivning	s	lägenhet
rockvaktmästare	rock
roddare	rodda	are
roddmaskin	rodd	maskin
romanförfattare	roman	författare
romanist	roman	ist
roskisdykare	roskis	dykare
rossling	rossla	ing
rotera	rot	era
rotlös	rot	lös
rotlöshet	rotlös	het
rubbning	rubba	ning
ruinera	ruin	era
rullning	rulla	ning
rumskamrat	rum	s	kamrat
rundning	runda	ning
rundvandring	rund
runstensfynd	runsten	s	fynd
rusning	rusa	ning
rusningstid	rusning	s	tid
rustning	rusta	ning
rutinmässig	rutin	mässig
rutinmässigt	rutinmässig	t
rutinärende	rutin	ärende
ryggrad	rygg	rad
ryggradsdjur	ryggrad	s	djur
rymdforskare	rymd	forskare
rymmare	rymma	are
rysare	rysa	are
ryskspråkig	rysk	språkig
rysning	rysa	ning
rytmiskt	rytmisk	t
räckvidd	räcka	vidd
räckviddsångest	räckvidd	ångest
räkfrossa	räka	frossa
räknare	räkna	are
ränteskillnad	ränta	skillnad
ränteskillnadsersättning	ränteskillnad	s	ersättning
rättegångsfel	rättegång	s	fel
rättning	rätta	ning
rättsligt	rättslig	t
rättsläge	rätt	s	läge
rättspsykiatriskt	rättspsykiatrisk	t
rättssal	rätt	s	sal
rättssäkerhet	rätt	s	säkerhet
rättssäkerhetsproblem	rättssäkerhet	s	problem
rättsvetenskaplig	rättsvetenskap	lig
rättsvetenskapligt	rättsvetenskaplig	t
rävunge	räv	unge
rådgivare	rådgiva	are
rådgivning	rådgiva	ning
rådsarbetsgrupp	råd
råkost	rå	kost
rånare	råna	are
råolja	rå	olja
rökare	röka	are
rökbomb	rök	bomb
rökig	rök	ig
rökning	röka	ning
rörelsemässig	rörelse	mässig
rörig	rör	ig
rörlig	rör	lig
rörlighet	rörlig	het
rörsångare	rör	sångare
röstkort	röst	kort
röstlärare	röst	lärare
röstning	rösta	ning
rösträtt	röst	rätt
rösträttsfråga	rösträtt	s	fråga
rötning	röta	ning
rötrest	röt	rest
rövare	röva	are
sabbatsljus	sabbat	s	ljus
sadist	Sade	ist
saffransbröd	saffran	s	bröd
saffransbulle	saffran	s	bulle
saftig	saft	ig
sakförklaring	sak	förklaring
saklig	sak	lig
saklighet	saklig	het
sakligt	saklig	t
salig	sal	ig
salladslök	sallad	s	lök
salthaltig	salthalt	ig
saltmätare	salt	mätare
saltning	salta	ning
samarbete	sam	arbete
samarbetspartner	samarbete
samarbetsvilja	samarbete
sambeskattning	sambeskatta	ning
samfundsminister	samfund	s	minister
samhällelig	samhälle	lig
samhälleligt	samhällelig	t
samhällsbyggnadsbolag	samhälle
samhällsekonomiskt	samhällsekonomisk	t
samhällsförändrande	samhälle	förändrande
samhällsvetenskaplig	samhällsvetenskap	lig
samlare	samla	are
samling	samla	ing
samlingsnamn	samling	s	namn
sammanblandning	sammanblanda	ning
sammandrabbning	sammandrabba	ning
sammandragning	sammandraga	ning
sammanfattning	sammanfatta	ning
sammanfattningsvis	sammanfattning	s	vis
sammanfoga	samman	foga
sammanfogning	sammanfoga	ning
sammankoppling	sammankoppla	ing
sammanställning	sammanställa	ning
sammansättning	sammansätta	ning
samordnare	samordna	are
samrådsgrupp	samråd
samtalsämne	samtal	s	ämne
samverkansgrupp	samverkan	s	grupp
sandkatt	sand	katt
sanering	sanera	ing
sankmark	sank	mark
sanktionera	sanktion	era
satsning	satsa	ning
saxare	saxa	are
saxofonist	saxofon	ist
scenarbetare	scen	arbetare
schablonmässig	schablon	mässig
schartauanism	schartauan	ism
sedvanlig	sedvana	lig
seglare	segla	are
segling	segla	ing
segmentera	segment	era
segrare	segra	are
sekelskifte	sekel	skifte
selektivt	selektiv	t
semesterersättning	semester	ersättning
semesterlägenhet	semester	lägenhet
semesterlöneskuld	semesterlön
semesterresa	semester	resa
semestervikarie	semester	vikarie
senfärdighet	senfärdig	het
sent	sen	t
separatist	separat	ist
separering	separera	ing
seriekoppling	seriekoppla	ing
serietecknare	serie	tecknare
serietidning	serie	tidning
seriöst	seriös	t
servering	servera	ing
serveringsgång	servering	s	gång
serviceverkstad	service	verkstad
sevärdhet	sevärd	het
sexarbetare	sex	arbetare
sexförbrytare	sex	förbrytare
sexig	sex	ig
sexigt	sexig	t
sexism	sex	ism
signalera	signal	era
signalist	signal	ist
signalpistol	signal	pistol
signering	signera	ing
sillfilé	sill	filé
silverräv	silver	räv
simmare	simma	are
sittning	sitta	ning
sjudning	sjuda	ning
sjukdomsbild	sjukdom	s	bild
sjukdomsförlopp	sjukdom	s	förlopp
sjukhus	sjuk	hus
sjukhusarkiv	sjukhus	arkiv
sjukhusavdelning	sjukhus	avdelning
sjukhusbibliotek	sjukhus	bibliotek
sjukhusbyggnad	sjukhus	byggnad
sjukhuschef	sjukhus	chef
sjukhusclown	sjukhus	clown
sjukhusdirektör	sjukhus	direktör
sjukhusenhet	sjukhus	enhet
sjukhusepidemiolog	sjukhus	epidemiolog
sjukhusfysiker	sjukhus	fysiker
sjukhuskorridor	sjukhus	korridor
sjukhuskyrka	sjukhus	kyrka
sjukhusläkare	sjukhus	läkare
sjukhusnämnd	sjukhus	nämnd
sjukhussäng	sjukhus	säng
sjukhustransportör	sjukhus	transportör
sjukhusvård	sjukhus	vård
sjukhusyrke	sjukhus	yrke
sjukledighet	sjukledig	het
sjuklig	sjuka	lig
sjuklönekostnad	sjuklön	e	kostnad
sjukpenning	sjuk	penning
sjukskrivning	sjukskriva	ning
sjukskrivningsorsak	sjukskrivning	s	orsak
sjuksköterska	sjuk	sköterska
sjukvårdsförsäkring	sjukvård	s	försäkring
sjukvårdsinrättning	sjukvård	s	inrättning
sjukvårdsinspektör	sjukvård	s	inspektör
sjukvårdslagstiftning	sjukvård	s	lagstiftning
sjukvårdsregion	sjukvård	s	region
sjukvårdsregionråd	sjukvård	s	regionråd
sjukvårdsrådgivare	sjukvård	s	rådgivare
sjukvårdsutbildning	sjukvård	s	utbildning
självförhärligande	själv	förhärligande
självgodhet	självgod	het
självkarantän	själv	karantän
självklarhet	självklar	het
självklart	självklar	t
självskada	själv	skada
självständighet	självständig	het
självständighetsförklaring	självständighet	s	förklaring
självständigt	självständig	t
självtänkande	själv	tänkande
sjåare	sjåa	are
sjöhäst	sjö	häst
sjökort	sjö	kort
sjömanshatt	sjöman	s	hatt
sjömanskyrka	sjöman	s	kyrka
sjöolycka	sjö	olycka
sjöprocent	sjö	procent
sjörapport	sjö	rapport
sjösättning	sjösätta	ning
skadeglädje	skada	glädje
skadlig	skada	lig
skadligt	skadlig	t
skaffning	skaffa	ning
skakning	skaka	ning
skalare	skala	are
skamlig	skam	lig
skamlös	skam	lös
skandalisera	skandal	isera
skandinavism	skandinav	ism
skapare	skapa	are
skapligt	skaplig	t
skatteavdrag	skatt	e	avdrag
skattedomstol	domstol
skatteexpert	skatt	e	expert
skatteförändring	skatt	e	förändring
skattekommission	skatt	e	kommission
skattemässigt	skattemässig	t
skattenytta	skatt	e	nytta
skatteplanering	skatteplanera	ing
skatterättsligt	skatterättslig	t
skenäktenskap	sken	äktenskap
skeppare	skeppa	are
skeppsgård	skepp	s	gård
skicklig	skick	lig
skiftarbetare	skift	arbetare
skiftning	skifta	ning
skildring	skildra	ing
skissbok	skiss	bok
skisstävling	skiss	tävling
skitarbete	skit	arbete
skitig	skit	ig
skitjobb	skit	jobb
skitmysig	skit
skitstövel	skit	stövel
skjutning	skjuta	ning
skogsarbetare	skog	s	arbetare
skogsbolag	skog	s	bolag
skogsbrand	skog	s	brand
skogsdunge	skog	s	dunge
skogsindustri	skog	s	industri
skogsparti	skog	s	parti
skogsvetenskap	skog	s	vetenskap
skogsvetenskaplig	skogsvetenskap	lig
skogsägare	skog	s	ägare
skogsödla	skog	s	ödla
skojigt	skojig	t
skolarbete	skola	arbete
skolarkiv	skol	arkiv
skolassistent	skol	assistent
skolbarn	skol	barn
skolbudget	skol	budget
skoldebattör	skol	debattör
skolflicka	skol	flicka
skolhem	skola	hem
skolhälsovård	skol	hälsovård
skolkare	skolka	are
skolkök	skol	kök
skolplattform	skol	plattform
skolstrejk	skol	strejk
skolstrejka	strejka
skolstängning	skola	stängning
skolutflykt	skol	utflykt
skolväsen	skol	väsen
skolämne	skol	ämne
skonare	skona	are
skonsam	skona	sam
skraplott	skrapa	lott
skrapning	skrapa	ning
skriftlig	skrift	lig
skriftligt	skriftlig	t
skriftspråk	skrift	språk
skriftspråklig	skriftspråk	lig
skrivare	skriva	are
skrivbordslampa	skrivbord	s	lampa
skrivning	skriva	ning
skrivningsvakt	skrivning	s	vakt
skrovlig	skrov	lig
skuldsanering	skuld	sanering
skumfälla	skum	fälla
skvättvis	skvätt	vis
skyddsombud	skydd	s	ombud
skyhögt	skyhög	t
skyldighet	skyldig	het
skyltmakare	skylt	makare
skyltning	skylta	ning
skäggborste	skägg	borste
skäggolja	skägg	olja
skäktning	skäkta	ning
skälig	skäl	ig
skäligt	skälig	t
skälmskt	skälmsk	t
skämtbild	skämt	bild
skämtsam	skämta	sam
skämtsamt	skämtsam	t
skärgårdskryssare	skärgård	s	kryssare
skärgårdsö	skärgård	s	ö
skärmtid	skärm	tid
skärmtidsbegränsning	skärmtid	s	begränsning
skärning	skära	ning
skärpning	skärpa	ning
skönhet	skön	het
skönhetsideal	skönhet	s	ideal
skötare	sköta	are
sköterska	skötare	-ska
skötsam	sköta	sam
slagsida	slag	sida
slagväxling	slag	växling
slaktare	slakta	are
slarvigt	slarvig	t
slavist	slav	ist
slavistiskt	slavistisk	t
slidkrans	slid	krans
slottsfru	slott	s	fru
slumpmässigt	slumpmässig	t
slussvärd	sluss	värd
slutare	sluta	are
slutenvårdsavdelning	slutenvård	s	avdelning
slutgiltigt	slutgiltig	t
slutlig	slut	lig
slutvokal	slut	vokal
släckare	släcka	are
släktforskare	släkt	forskare
släktforskning	släkt	forskning
släkthistoria	släkt	historia
släktled	släkt	led
slöjdkniv	slöjd	kniv
smaklig	smak	lig
smaklös	smak	lös
smakmässig	smak	mässig
smakmässigt	smakmässig	t
smaksättare	smaksätta	are
smaksättning	smaksätta	ning
smidigt	smidig	t
smittbärare	smitta	bärare
smittsam	smitta	sam
smugglare	smuggla	are
smuggling	smuggla	ing
smutsig	smuts	ig
smygflyga	smyga	flyga
smällare	smälla	are
smärtsamt	smärtsam	t
småhusförening	småhus	förening
småhusmontör	småhus	montör
småhusområde	småhus	område
småskalighet	småskalig	het
småstadsbo	småstad	s	bo
smörgås	smör	gås
smörgåsbord	smörgås	bord
smörgåstårta	smörgås	tårta
smörjning	smörja	ning
smörkniv	smör	kniv
snabbhet	snabb	het
snabbt	snabb	t
snarkning	snarka	ning
snart	snar	t
snattare	snatta	are
snidare	snida	are
snippbastu	snippa
snusare	snusa	are
snusdosa	snus	dosa
snusfabrik	snus	fabrik
snuskhummer	snuskig	hummer
snuskighet	snuskig	het
snuskigt	snuskig	t
snusning	snusa	ning
snustillverkning	snus	tillverkning
snyftning	snyfta	ning
snygging	snygga	ing
snyltare	snylta	are
snyting	snyta	ing
snällt	snäll	t
snöbollsbuske	snöboll	s	buske
snöbollskrig	snöboll	s	krig
snöfri	snö	fri
snömos	snö	mos
snöplogning	snöploga	ning
snösparv	snö	sparv
socialförsäkringsminister	socialförsäkring	s	minister
socialförsäkringspension	socialförsäkring	s	pension
socialism	social	ism
socialist	social	ist
socialistregering	socialist	regering
socioekonomiskt	socioekonomisk	t
socionomexamen	socionom	examen
socionomutbildning	socionom	utbildning
sockenbibliotek	socken	bibliotek
sockerersättning	socker	ersättning
sockerfri	socker	fri
sockerhaltig	sockerhalt	ig
sockertillverkning	socker	tillverkning
sojapojke	soja	pojke
sol-och-vårare	sol-och-våra	are
solenergi	sol	energi
solfläck	sol	fläck
solist	solo	ist
solnedgång	sol	nedgång
solresa	sol	resa
solsystemet	sol	system
sommarbröllop	sommar	bröllop
sommarhus	sommar	hus
sommarjobb	sommar	jobb
sommarkatt	sommar	katt
sommarklänning	sommar	klänning
sommarkurs	sommar	kurs
sommarkyrka	sommar	kyrka
sommarlov	sommar
sommarpotatis	sommar	potatis
sommarresidens	sommar	residens
sommarsallad	sommar	sallad
sommarsemester	sommar	semester
sommarställe	sommar	ställe
sommartid	sommar	tid
sommarvilla	sommar	villa
sommarålänning	sommar	ålänning
sonson	son
sorglig	sorg	lig
sorgligt	sorglig	t
sortera	sort	era
sossetidning	sosse	tidning
sotare	sota	are
spanare	spana	are
spanskspråkig	spansk	språkig
specialbehandling	specialbehandla	ing
specialisering	specialisera	ing
specialistläkare	specialist	läkare
specialistsjukhus	specialist	sjukhus
specialistsjuksköterskeexamen	specialistsjuksköterska	examen
specialpedagogexamen	specialpedagog	examen
speciellt	speciell	t
spejare	speja	are
spelare	spela	are
spelmässig	spel	mässig
spelning	spela	ning
spelutvecklare	spel	utvecklare
spenatstuvning	spenat	stuvning
spetsig	spets	ig
spexig	spex	ig
spikig	spik	ig
spikmatta	spik	matta
spindeldjur	spindel	djur
spionera	spion	era
splittring	splittra	ing
spolning	spola	ning
sportaffär	sport	affär
sportbutik	sport	butik
sportdykning	sport	dykning
sportig	sport	ig
sportklocka	sport	klocka
spridare	sprida	are
spridning	sprida	ning
springare	springa	are
springråtta	springa	råtta
sprinttävling	sprint	tävling
sprutlackerare	sprutlackera	are
sprängladdning	laddning
sprängning	spränga	ning
språkbruk	språk	bruk
språkfamilj	språk	familj
språkforskare	språk	forskare
språkforskning	språk	forskning
språkfärdighet	språk	färdighet
språkgrupp	språk	grupp
språkhistoriskt	språkhistorisk	t
språkkonsult	språk	konsult
språkkurs	språk	kurs
språklig	språk	lig
språkljud	språk	ljud
språklärare	språk	lärare
språkminoritet	språk	minoritet
språkområde	språk	område
språkpedagog	språk	pedagog
språkpolis	språk	polis
språkpolitik	språk	politik
språkresa	språk	resa
språksamfund	språk	samfund
språksituation	språk	situation
språkskola	språk	skola
språkstörning	språk	störning
språksystem	språk	system
språkteknologi	språk	teknologi
språkteknologiskt	språkteknologisk	t
språkteori	språk	teori
språkundervisning	språk	undervisning
språkunion	språk	union
språkutbildning	språk	utbildning
språkvetenskap	språk	vetenskap
språkvetenskaplig	språkvetenskap	lig
språkvetenskapligt	språkvetenskaplig	t
språkvård	språk	vård
spydighet	spydig	het
spädning	späda	ning
spärrballong	spärr	ballong
spårvägsförbindelse	spårväg	s	förbindelse
stabilisera	stabil	isera
stadig	stad	ig
stadigt	stadig	t
stadsarkitekt	stad	s	arkitekt
stadsdelsförvaltning	stadsdel	s	förvaltning
stadsförsamling	stad	s	församling
stadsförvaltning	stad	s	förvaltning
stadsingenjör	stad	s	ingenjör
stadskarta	stad	s	karta
stadsmuseum	stad	s	museum
stadsrättighet	stad	s	rättighet
stadsvandring	stad	s	vandring
stallgödsel	stall	gödsel
standardisera	standard	isera
standardisering	standardisera	ing
standardspråk	standard	språk
standardverk	standard	verk
startdatum	start	datum
startkabel	start	kabel
startkapital	start
startupföretag	startup	företag
stationsbyggnad	station	s	byggnad
statistiskt	statistisk	t
statlig	stat	lig
statsangelägenhet	stat	s	angelägenhet
statsbidrag	stat	s	bidrag
statsgräns	stat	s	gräns
statskupp	stat	s	kupp
statsministerbostad	statsminister	bostad
statsministerkandidat	statsminister	kandidat
statsreligion	stat	s	religion
statsvetenskaplig	statsvetenskap	lig
statussymbol	status	symbol
statyprotest	staty	protest
stavhopp	stav
stavning	stava	ning
stavningsreform	stavning	s	reform
stegring	stegra	ing
stegvis	steg	vis
stekbord	stek	bord
stekning	steka	ning
stekost	stek	ost
stelhet	stel	het
stenkyrka	sten	kyrka
stenverktyg	sten	verktyg
sterbhus	hus
sterilisering	sterilisera	ing
stiftelsehögskola	stiftelse	högskola
stigning	stiga	ning
stilbrott	stil	brott
stilig	stil	ig
stilist	stil	ist
stilmässig	stil	mässig
stimulering	stimulera	ing
stjärnstopp	stjärna	stopp
stockning	stocka	ning
storhelg	stor	helg
storhet	stor	het
storkök	stor
storleksgrupp	storlek	s	grupp
storleksordning	storlek	s	ordning
stormning	storma	ning
storstadsbo	storstad	s	bo
storstadsförort	storstad	s	förort
storstädning	storstäda	ning
straffskärpningsgrund	straffskärpning	s	grund
strandhus	strand	hus
strategiförändring	strategi	förändring
strategiskt	strategisk	t
streckkod	streck	kod
strejkbrytare	strejk
strejkvakt	strejk	vakt
strukturera	struktur	era
strykare	stryka	are
strypare	strypa	are
sträckare	sträcka	are
sträckning	sträcka	ning
strävhet	sträv	het
strålning	stråla	ning
strålningsnivå	strålning	s	nivå
strömbrytare	ström	brytare
strömming	strömma	ing
strömstyrka	ström	styrka
studentbostad	student	bostad
studentförbund	student	förbund
studentförening	student	förening
studenthem	student	hem
studentkår	student	kår
studentlägenhet	student	lägenhet
studentmössa	student	mössa
studentprotest	student	protest
studentteater	student	teater
studentuppsats	student	uppsats
studentår	student	år
studiehandbok	studie	handbok
studiekamrat	studie	kamrat
studieplats	studie	plats
studiesal	studie	sal
studioalbum	studio	album
studsare	studsa	are
stundist	stund	ist
stupig	stup	ig
stuvning	stuva	ning
styckmördare	styckmörda	are
styckning	stycka	ning
stympare	stympa	are
styrelseform	styrelse	form
styrelsemedlem	styrelse	medlem
styrning	styra	ning
styvmoderligt	styvmoderlig	t
städare	städa	are
städning	städa	ning
ställbar	ställa	bar
ställning	ställa	ning
ställskruv	skruv
ständigt	ständig	t
stängning	stänga	ning
stålrör	stål	rör
stökigt	stökig	t
störning	störa	ning
subventionera	subvention	era
suddig	sudd	ig
surströmmingslåda	surströmming	s	låda
surströmmingssemla	surströmming	s	semla
surströmmingstunna	surströmming	s	tunna
sushirestaurang	sushi	restaurang
svaghet	svag	het
svampart	svamp	art
svampkniv	svamp	kniv
svampparasit	svamp	parasit
svampstuvning	svamp	stuvning
svanhals	svan	hals
svansföring	svans
svanslös	svans	lös
svarvare	svarva	are
svavelfri	svavel	fri
svavelhaltig	svavel	haltig
svenskamerikan	svensk	amerikan
svenskhet	svensk	het
svenskspråkig	svensk	språkig
svepning	svepa	ning
svetsare	svetsa	are
svetsning	svetsa	ning
svettig	svett	ig
svettning	svetta	ning
svikare	svika	are
svindlare	svindla	are
svinrygg	svin	rygg
svänghjul	sväng	hjul
svängning	svänga	ning
svärmorslucka	svärmor	s	lucka
svävare	sväva	are
svårt	svår	t
sydkanadensisk	syd	Kanada	ensisk
sydlig	syd	lig
sydvästlig	sydväst	lig
syftning	syfta	ning
syltning	sylta	ning
symbolhandling	symbol	handling
symbolisera	symbol	isera
symbolism	symbol	ism
symmetriplan	symmetri	plan
synare	syna	are
syndare	synda	are
syndig	synd	ig
syndigt	syndig	t
synlig	syn	lig
synlighet	synlig	het
syrebrist	syre	brist
syrenivå	syre	nivå
syrlig	syra	lig
syrlighet	syrlig	het
sysselsättning	sysselsätta	ning
syssling	syssla	ing
sysslolöshet	sysslolös	het
systemadministratör	system	administratör
systematiskt	systematisk	t
systemfel	system	fel
systemskifte	system	skifte
systemutveckling	system	utveckling
systemutvecklingsprocess	systemutveckling	s	process
systerförening	syster	förening
systerlig	syster	lig
säckig	säck	ig
säkerhet	säker	het
säkerhetsinvestering	säkerhet	s	investering
säkerhetskonsult	säkerhet	s	konsult
säkerhetsrisk	säkerhet	s	risk
säkerhetsstyrka	säkerhet	s	styrka
säkerhetsåtgärd	säkerhet	s	åtgärd
säkert	säker	t
säkring	säkra	ing
säkringsdosa	säkring	s	dosa
säljare	sälja	are
sällskaplig	sällskap	lig
sällskapsdjur	sällskap	s	djur
sällskapshund	sällskap	s	hund
sändare	sända	are
sändning	sända	ning
sängbord	säng	bord
sängkläder	säng	kläder
sänglampa	säng	lampa
sänkning	sänka	ning
särskiljning	särskilja	ning
särskrivning	särskriva	ning
säsongsarbetare	säsong	s	arbetare
säsongsförskjutning	säsong	s	förskjutning
säsongsvis	säsong	s	vis
sättning	sätta	ning
sävligt	sävlig	t
sågning	såga	ning
sållning	sålla	ning
sånglärare	sång	lärare
sångpedagog	sång	pedagog
sångtext	sång	text
sångtävling	sång	tävling
sårbar	såra	bar
sårbarhet	sårbar	het
sårig	sår	ig
sökare	söka	are
sökbar	söka	bar
sökformulär	söka
sökning	söka	ning
sömnforskare	sömn	forskare
sömnlös	sömn	lös
sömnstörning	sömn	störning
söndagsbarn	söndag	s	barn
söndagsbilaga	söndag	s	bilaga
söndagsbilist	söndag	s	bilist
söndagskväll	söndag	s	kväll
söndagsmiddag	söndag	s	middag
söndagsseglare	söndag	seglare
sönderbomba	sönder	bomba
sönderdela	sönder
sönderdelning	sönderdela	ning
tackling	tackla	ing
tacksam	tack	sam
tacksamhet	tacksam	het
tacksamt	tacksam	t
taggtråd	tagg	tråd
taktmässig	takt	mässig
talare	tala	are
talbar	tala	bar
talman	tal	man
talregistrering	tal	registrering
talregistreringsapparat	talregistrering	s	apparat
talsyntes	tal	syntes
taltidning	tal	tidning
tandborste	tand	borste
tandhygienistexamen	tandhygienist	examen
tandlös	tand	lös
tandvårdsförsäkring	tandvård	s	försäkring
tangentbord	tangent	bord
tangentbordskrigare	tangentbord	s	krigare
tankefel	tanke	fel
tankemetod	tanke	metod
tankesmedja	tanke	smedja
tankstation	tank	station
tankvagn	tank	vagn
tapetserare	tapetsera	are
tappning	tappa	ning
tatuerare	tatuera	are
tatuering	tatuera	ing
taxera	tax	era
taxichaufför	taxi	chaufför
taxiresa	taxi	resa
teammedlem	team
teaterbesökare	teater	besökare
teaterbyggnad	teater	byggnad
teaterfestival	teater	festival
teaterförening	teater	förening
teatergrupp	teater	grupp
teaterhögskola	teater	högskola
teaterscen	teater	scen
teaterutbildning	teater	utbildning
teckenspråk	tecken	språk
teckenspråkig	teckenspråk	ig
teckenspråksanvändare	teckenspråk	s	användare
teckenspråkskurs	teckenspråk	s	kurs
teckenspråkslärare	teckenspråk	s	lärare
teckenspråkstolk	teckenspråk	s	tolk
teckenspråksutbildning	teckenspråk	s	utbildning
tecknare	teckna	are
teckningslärare	teckning	s	lärare
teckningslärarinna	teckning	s	lärarinna
teckningsrätt	teckning	s	rätt
teckningsskola	teckning	s	skola
tegelkyrka	tegel	kyrka
teknikutveckling	teknik	utveckling
tekniskt	teknisk	t
telefax	tele	fax
telefon	tele	fon
telefonabonnent	telefon	abonnent
telefonavlyssning	telefon	avlyssning
telefonförsäljare	telefon	försäljare
telefonförsäljning	telefon	försäljning
telefonhot	telefon	hot
telefonintervju	telefon	intervju
telefonist	telefon	ist
telefonjack	telefon	jack
telefonkabel	telefon	kabel
telefonkatalog	telefon	katalog
telefonkiosk	telefon	kiosk
telefonklyka	telefon	klyka
telefonnummer	telefon	nummer
telefonnät	telefon	nät
telefonsamtal	telefon	samtal
telefontid	telefon	tid
telefonväxel	telefon	växel
telesamtal	tele	samtal
teleskop	tele	skop
teleskopord	teleskop	ord
teletjänstcentral	tele	tjänst	central
television	tele
temadag	tema	dag
tematiskt	tematisk	t
temperaturförändring	temperatur	förändring
temperatursvängning	temperatur	svängning
temperaturökning	temperatur	ökning
temporärt	temporär	t
temugg	te	mugg
tennishall	tennis	hall
tennistävling	tennis	tävling
tentamensbok	tentamen	s	bok
tentamensläsning	tentamensläsa	ning
teologiprofessor	teologi	professor
teologiskt	teologisk	t
teologistudent	teologi	student
terapisamtal	terapi	samtal
terminalarbetare	terminal	arbetare
terminalbyggnad	terminal	byggnad
terrorbrott	terror	brott
terrorisera	terror	isera
terrorism	terror	ism
terrorist	terror	ist
terroristorganisation	terrorist	organisation
terrängbil	terräng	bil
terrängfordon	terräng	fordon
testare	testa	are
testbild	test	bild
testning	testa	ning
textlingvistik	text	lingvistik
textmässig	text	mässig
textsamling	text	samling
texttelefon	text	telefon
tidig	tid	ig
tidlös	tid	lös
tidningsartikel	tidning	s	artikel
tidningsbilaga	tidning	s	bilaga
tidningshållare	tidning	s	hållare
tidningskiosk	tidning	s	kiosk
tidningskung	tidning	s	kung
tidningsledare	tidning	s	ledare
tidningsnotis	tidning	s	notis
tidningsrapport	tidning	s	rapport
tidningsrubrik	tidning	s	rubrik
tidsbesparing	tid	s	besparing
tidsbestämma	tid	s	bestämma
tidsintervall	tid	s	intervall
tidskriftssamlare	tidskrift	s	samlare
tidsmaskin	tid
tidsålder	tid	s	ålder
tidvis	tid	vis
tiggare	tigga	are
tillaga	till	aga
tillagning	tillaga	ning
tillagningstid	tillagning	s	tid
tillbringa	till	bringa
tillbringare	tillbringa	are
tilldela	till	dela
tilldelning	tilldela	ning
tilldra	till	dra
tillerkänna	till	erkänna
tillfalla	till	falla
tillfoga	till	foga
tillfråga	till	fråga
tillfälligt	tillfällig	t
tillfälligtvis	tillfällig	t	vis
tillföra	till	föra
tillförlitlighet	tillförlitlig	het
tillförsäkra	till	försäkra
tillge	till	ge
tillgiva	till	giva
tillgänglighet	tillgänglig	het
tillgänglighetsredogörelse	tillgänglighet	s	redogörelse
tillhöra	till	höra
tillkalla	till	kalla
tillkomma	till	komma
tillreda	till	reda
tillredningstid	till	redning	s	tid
tillräckligt	tillräcklig	t
tillse	till	se
tillskriva	till	skriva
tillsluta	till	sluta
tillståndspliktig	tillståndsplikt	ig
tillståndsprövning	tillstånd	s	prövning
tillsynschef	chef	tilsyn	-s-
tillsätta	till	sätta
tillsättning	tillsätta	ning
tilltala	till	tala
tillträda	till	träda
tillverka	till	verka
tillverkare	tillverka	are
tillverkning	tillverka	ning
tillverkningsmetod	tillverkning	s	metod
tillverkningsår	tillverkning	s	år
tillväxa	till	växa
tilläggsbidrag	tillägg	s	bidrag
tilläggsförsäkring	tillägg	s	försäkring
tillägna	till	ägna
tillämpning	tillämpa	ning
tillämpningskurs	tillämpning	s	kurs
tingsrätt	ting	s	rätt
tinning	tina	ning
tiotusen	tio	tusen
tippficka	tippa	ficka
titelförsvarare	titel	försvarare
titelkyrka	titel	kyrka
titelsida	titel	sida
tittare	titta	are
tjackdröm	tjack	dröm
tjejkompis	tjej	kompis
tjejmiddag	tjej	middag
tjejtidning	tjej	tidning
tjugotal	tjugo	tal
tjugotalist	tjugotal	ist
tjugoårig	tjugo	årig
tjusning	tjusa	ning
tjuvlyssnare	tjuvlyssna	are
tjänare	tjäna	are
tjänsteman	tjänst
tjänstgöring	tjänstgöra	ing
tjänstledighet	tjänstledig	het
toalettbesök	toalett	besök
tobaksbutik	tobak	s	butik
tobaksprodukt	tobak	s	produkt
tobaksrökning	tobak	s	rökning
tofsprydd	tofs	pryda
tokig	tok	ig
tokigt	tokig	t
tokstolle	tok	stolle
tolkning	tolka	ning
tolkningsmöjlighet	tolkning	s	möjlighet
tolkskola	tolk	skola
tomatklyfta	tomat	klyfta
tomatpuré	tomat	puré
tomatsoppa	tomat	soppa
tomtegubbe	tomte	gubbe
tomtenisse	tomte	nisse
tonfisksallad	tonfisk	sallad
tonsättare	tonsätta	are
tonsättning	tonsätta	ning
topplacering	topp	placering
torgmöte	torg	möte
torkning	torka	ning
torktumlare	torktumla	are
torrläggning	torrlägga	ning
torrötning	torr	rötning
torrötningsprocess	torrötning	s	process
torskfilé	torsk	filé
tortillabröd	tortilla	bröd
totalt	total	t
totalvägrare	totalvägra	are
traditionellt	traditionell	t
trafikavgift	trafik	avgift
trafikera	trafik	era
trafikforskare	trafik	forskare
trafikförsäkring	trafik	försäkring
trafikljus	trafik	ljus
trafikmiljö	trafik	miljö
trafikolycka	trafik	olycka
trafikpolis	trafik	polis
trafikskola	trafik	skola
trafikstörning	trafik	störning
trafiksäkerhet	trafik	säkerhet
trafiksäkert	trafiksäker	t
trafikvärd	trafik	värd
tragiskt	tragisk	t
traktorförare	traktor	förare
transformering	transformera	ing
transportband	transport	band
transportera	transport	era
transportledare	transport	ledare
transportsystem	transport
tredjepart	tredje	part
trehundra	tre	hundra
trendig	trend	ig
trendmässig	trend	mässig
trettiofyra	trettio	fyra
trettioårig	trettio	årig
trevligt	trevlig	t
treårig	tre	årig
trilling	trilla	ing
trivialisera	trivial	isera
trofast	tro
trollbinda	trolla
trolös	tro	lös
trotsigt	trotsig	t
trovärdighet	trovärdig	het
trumfkort	trumf	kort
tryckare	trycka	are
trygghet	trygg	het
trygghetssystem	trygghet	s	system
träbyggnad	trä	byggnad
trädalgoritm	träd	algoritm
trädgård	träd	gård
trädgårdsarkitekt	trädgård	s	arkitekt
trädgårdspaviljong	trädgård	s	paviljong
trädkrona	träd	krona
trädlärka	träd	lärka
trädsvamp	träd	svamp
träfallos	trä	fallos
träkolsgrillad	träkol	grilla
tränare	träna	are
träslev	trä	slev
tråckling	tråckla	ing
trådlös	tråd	lös
trådlöshet	trådlös	het
tråkigt	tråkig	t
trögt	trög	t
tröskelnivå	tröskel	nivå
tröstare	trösta	are
tröttmössa	trött	mössa
tröttsam	trött	sam
tullare	tulla	are
tullavgift	tull	avgift
tulltjänsteman	tull	tjänsteman
tumlare	tumla	are
tunneleffekt	tunnel	effekt
tunneltågförare	tunnel	tåg	förare
tunnland	tunn
tupplur	tupp	lur
turism	tur	ism
turist	tur	ist
turistbuss	turist	buss
turistbyrå	turist	byrå
turistförening	turist	förening
turistinformation	turist	information
turistinformatör	turist	informatör
turistkarta	turist	karta
turistkorridor	turist	korridor
turistorganisation	turist	organisation
turiststuga	turist	stuga
turistvagn	turist	vagn
turkiskspråkig	turkisk	språkig
turnering	turnera	ing
tveksam	tveka	sam
tvetydighet	tvetydig	het
tvivlare	tvivla	are
tvärbromsning	tvärbromsa	ning
tvärkonstnärlig	tvär
tvärvetenskaplig	tvärvetenskap	lig
tvärvetenskapligt	tvärvetenskaplig	t
tvättbjörn	björn
tvättkorg	tvätt	korg
tvättmaskin	tvätta	maskin
tvåmetersregel	två	meter	regel
tvångsförflyttning	tvång
tvångssterilisering	tvångssterilisera	ing
tvångsåtgärd	tvång	s	åtgärd
tvåspråkighet	tvåspråkig	het
twittrare	twittra	are
tyckare	tycka	are
tydlighet	tydlig	het
tydligt	tydlig	t
tygellös	tygel	lös
typexempel	typ	exempel
typfall	typ	fall
tyskfödd	tysk	född
tyskspråkig	tysk	språkig
tystnad	tysta	nad
tystnadskultur	tystnad
täljare	tälja	are
tändare	tända	are
tändning	tända	ning
tänjning	tänja	ning
tänkare	tänka	are
tänkbar	tänka	bar
tänkbart	tänkbar	t
tärning	tära	ning
tärningsspel	tärning	s	spel
tärningsspelare	tärning	s	spelare
tätning	täta	ning
tävling	tävla	ing
tävlingsdeltagare	tävling	s	deltagare
tävlingsförare	tävling	s	förare
tävlingsplattform	tävling	s	plattform
tävlingsprocess	tävling
tågförsening	tåg	försening
tågluffare	tågluffa	are
tågnät	tåg	nät
tågolycka	tåg	olycka
tågresa	tåg	resa
tågskryta	tåg	skryta
tågtunnel	tåg	tunnel
tålig	tåla	ig
tålmodigt	tålmodig	t
tölpig	tölp	ig
tölpigt	tölpig	t
töntig	tönt	ig
töntigt	töntig	t
ugnsform	ugn	s	form
umgängesliv	umgänge	s	liv
undantagsvis	undantag	s	vis
underentreprenör	under	entreprenör
undergång	under	gång
underhållsstöd	underhåll	s	stöd
underindelning	underindela	ning
underklänning	under	klänning
underligt	underlig	t
understrykning	understryka	ning
undersökning	undersöka	ning
undersökningsbrits	undersökning	s	brits
undertecknare	underteckna	are
underturism	under	turism
undervisning	undervisa	ning
undervisningsgrupp	undervisning	s	grupp
undervisningsmiljö	undervisning	s	miljö
undervisningsminister	undervisning	s	minister
undervisningsspråk	undervisning	s	språk
undring	undra	ing
undsättning	undsätta	ning
ungdomlig	ungdom	lig
ungdomsbiljett	ungdom	s	biljett
ungdomsbrottslighet	ungdom	s	brottslighet
ungdomshem	ungdom	s	hem
ungdomslag	ungdom	s	lag
ungdomslitteratur	ungdom	s	litteratur
ungdomsmottagning	ungdom	s	mottagning
ungdomsorganisation	ungdom	s	organisation
ungdomsroman	ungdom	s	roman
ungdomsverksamhet	ungdom	s	verksamhet
ungerskspråkig	ungersk	språkig
uniformsjacka	uniform	s	jacka
uniformsmössa	uniform	s	mössa
unikt	unik	t
unionist	union	ist
universitetsadjunkt	universitet	s	adjunkt
universitetsbibliotek	universitet	s	bibliotek
universitetsbibliotekarie	universitet	s	bibliotekarie
universitetsbyggnad	universitet	s	byggnad
universitetsexamen	universitet	s	examen
universitetsforskning	universitet	s	forskning
universitetsinstitution	universitet	s	institution
universitetskansler	universitet	s	kansler
universitetskurs	universitet	s	kurs
universitetslektor	universitet	s	lektor
universitetslärare	universitet	s	lärare
universitetsprofessor	universitet	s	professor
universitetssjukhus	universitet	s	sjukhus
universitetsstad	universitet	s	stad
universitetsstudent	universitet	s	student
universitetsutbildning	universitet	s	utbildning
upparbeta	upp	arbeta
uppdatering	uppdatera	ing
uppdelning	uppdela	ning
uppdragsutbildning	uppdrag	s	utbildning
uppdukning	uppduka	ning
uppehållstillstånd	uppehåll	s	tillstånd
uppenbart	uppenbar	t
uppfattning	uppfatta	ning
uppfinnare	uppfinna	are
uppfostrare	uppfostra	are
uppföljningsutbildning	uppföljning	s	utbildning
uppförandekod	uppförande	kod
uppgradering	uppgradera	ing
upphandling	upphandla	ing
upphovskvinna	upphov	s	kvinna
upphovsrätt	upphov	s	rätt
upphöjning	upphöja	ning
upplysning	upplysa	ning
upplysningsvis	upplysning	s	vis
upplösning	upplösa	ning
upprusta	upp	rusta
upprustning	upprusta	ning
uppsatshandledare	uppsats	handledare
uppskattning	uppskatta	ning
uppskattningsvis	uppskattning	s	vis
uppsägning	uppsäga	ning
uppsättning	uppsätta	ning
upptagenhet	upptagen	het
upptäckare	upptäcka	are
uppviglare	uppvigla	are
urinering	urinera	ing
urskogsmiljö	urskog	s	miljö
ursprunglig	ursprung	lig
ursprungsbefolkning	ursprung	s	befolkning
ursprungsfolk	ursprung	s	folk
uselt	usel	t
utackordera	ut	ackordera
utanförskapsområde	utanförskap	s	område
utannonsera	ut	annonsera
utarbeta	ut	arbeta
utbetala	ut	betala
utbetalare	utbetala	are
utbetalning	utbetala	ning
utbilda	ut	bilda
utbildare	utbilda	are
utbildning	utbilda	ning
utbildningsadministratör	utbildning	s	administratör
utbildningsfartyg	utbildning	s	fartyg
utbildningsföretag	utbildning	s	företag
utbildningsinsats	utbildning	s	insats
utbildningskonsult	utbildning	s	konsult
utbildningsmaterial	utbildning	s	material
utbildningsmässigt	utbildningsmässig	t
utbildningssjukhus	utbildning	s	sjukhus
utbildningsvetare	utbildning	s	vetare
utbildningsvetenskap	utbildning	s	vetenskap
utbildningsvetenskaplig	utbildningsvetenskap	lig
utbrista	ut	brista
utbryta	ut	bryta
utbrytare	utbryta	are
utbrytning	utbryta	ning
utbyta	ut	byta
utdela	ut	dela
utdelning	utdela	ning
utdöma	ut	döma
utemiljö	ut	e	miljö
uteslutning	utesluta	ning
utexaminera	ut	examinera
utfiska	ut	fiska
utflagga	ut	flagga
utflyktsmål	utflykt	s	mål
utfodra	ut	fodra
utforma	ut	forma
utformning	utforma	ning
utforska	ut	forska
utforskare	utforska	are
utföra	ut	föra
utförare	utföra	are
utförligt	utförlig	t
utförsäkra	ut	försäkra
utge	ut	ge
utgiva	ut	giva
utgivare	utgiva	are
utgivning	utgiva	ning
utgå	ut	gå
utgöra	ut	göra
uthyra	ut	hyra
uthyrare	uthyra	are
uthyrning	uthyra	ning
uthärda	ut	härda
utjämna	ut	jämna
utklassa	ut	klassa
utklassning	utklassa	ning
utkomma	ut	komma
utkonkurrera	ut	konkurrera
utkämpa	ut	kämpa
utlandsmyndighet	utland	s	myndighet
utlopp	ut	lopp
utlysa	ut	lysa
utlysning	utlysa	ning
utläsa	ut	läsa
utlösa	ut	lösa
utlösning	utlösa	ning
utmana	ut	mana
utmanare	utmana	are
utmärka	ut	märka
utmäta	ut	mäta
utmätning	utmäta	ning
utmåla	ut	måla
utnyttja	ut	nyttja
utnämna	ut	nämna
utomeuropeiskt	utomeuropeisk	t
utomordentligt	utomordentlig	t
utpeka	ut	peka
utplåna	ut	plåna
utpressningsvirus	utpressning	s	virus
utreda	ut	reda
utredare	utreda	are
utredning	utreda	ning
utrikespolitiskt	utrikespolitisk	t
utropa	ut	ropa
utropare	utropa	are
utrota	ut	rota
utrotning	utrota	ning
utrusta	ut	rusta
utrustning	utrusta	ning
utrymma	ut	rymma
uträkna	ut	räkna
uträtta	ut	rätta
utröna	ut	röna
utsatthet	utsatt	het
utse	ut	se
utseendemässig	utseende	mässig
utseendemässigt	utseendemässig	t
utskilja	ut	skilja
utslockna	ut	slockna
utsmycka	ut	smycka
utsmyckning	utsmycka	ning
utspela	ut	spela
utspisa	ut	spisa
utspisning	utspisa	ning
utställa	ut	ställa
utställning	utställa	ning
utställningslokal	utställning	s	lokal
utstå	ut	stå
utsätta	ut	sätta
utsättning	utsätta	ning
utsöndra	ut	söndra
uttagning	ut	tagning
uttagningsprov	uttagning	prov
uttala	ut	tala
uttalsvariant	uttal	s	variant
uttrycka	ut	trycka
uttrycklig	uttryck	lig
uttryckligt	uttrycklig	t
uttryckslöst	uttryckslös	t
utträda	ut	träda
utvandra	ut	vandra
utvandrare	utvandra	are
utvandring	utvandra	ing
utveckla	ut	veckla
utvecklare	utveckla	are
utveckling	utveckla	ing
utvecklingsamtal	utveckling	samtal	-s-
utvecklingschef	utveckling	s	chef
utvecklingsersättning	utveckling	s	ersättning
utvecklingsinsats	utveckling	s	insats
utvecklingskostnad	utveckling
utvecklingsmål	utveckling	s	mål
utvecklingsplan	utveckling	s	plan
utvecklingsprojekt	utveckling	s	projekt
utvecklingsrubbning	utveckling	s	rubbning
utvecklingssamarbete	utveckling	s	samarbete
utvecklingsstörning	utveckling	s	störning
utvecklingsverksamhet	utveckling	s	verksamhet
utvidga	ut	vidga
utvidgning	utvidga	ning
utvinna	ut	vinna
utvisa	ut	visa
utvisning	utvisa	ning
utvärdera	ut	värdera
utvärderare	utvärdera	are
utvärdering	utvärdera	ing
utöka	ut	öka
utökning	utöka	ning
utöva	ut	öva
utövare	utöva	are
vaccinationspass	vaccination	s	pass
vaccinationsprogram	vaccination	s	program
vaccinera	vaccin	era
vaccinering	vaccinera	ing
vaccinturist	vaccin	turist
vackert	vacker	t
vadare	vada	are
vaddera	vadd	era
vaddering	vaddera	ing
vakning	vaka	ning
vaksam	vak	sam
vaksamhet	vaksam	het
valarbetare	valarbeta	are
valfrihet	valfri	het
validering	validera	ing
valkretsmandat	valkrets	mandat
valsystem	val	system
valtala	val	tala
valår	val	år
vandalisering	vandalisera	ing
vandrare	vandra	are
vandring	vandra	ing
vaniljsocker	vanilj	socker
vaniljsås	vanilj	sås
vanlig	vana	lig
vanligtvis	vanlig
vanskligt	vansklig	t
vapenaffär	vapen	affär
vapenfabrik	vapen	fabrik
vapenägare	vapen	ägare
varaktigt	varaktig	t
vardaglig	vardag	lig
vardaglighet	vardaglig	het
vardagligt	vardaglig	t
vardagsrätt	vardag	s	rätt
varsam	var	sam
varsamhet	varsam	het
varsamt	varsam	t
varuhusbesökare	varuhus	besökare
vattenbuffel	vatten	buffel
vattenekolog	vatten	ekolog
vattenflaska	vatten	flaska
vattenkanna	vatten	kanna
vattenkvarn	vatten	kvarn
vattenledning	vatten	ledning
vattenskoter	vatten	skoter
vattenskoterförare	vattenskoter	förare
vattensköldpadda	vatten	sköldpadda
vattenspindel	vatten	spindel
vattensäng	vatten	säng
vattentorn	vatten	torn
vattenyta	vatten	yta
vaxare	vaxa	are
veckolön	vecka	lön
veckomeny	vecka	o	meny
veckonummer	vecka	nummer
veckopendlare	veckopendla	are
veckoplanera	vecka	planera
vedergällning	vedergälla	ning
veganism	vegan	ism
vegetarianism	vegetarian	ism
vegointernationalism	vego
veling	vela	ing
ventilera	ventil	era
verbform	verb	form
verklig	verk	lig
verklighet	verklig	het
verklighetsbubbla	verklighet	s	bubbla
verkning	verka	ning
verkningsgrad	verkning
verksam	verk	sam
verksamhet	verksam	het
verksamhetsbidrag	verksamhet	s	bidrag
verksamhetsform	verksamhet	s	form
verkstadsarbetare	verkstad	s	arbetare
verkstadsmekaniker	verkstad	s	mekaniker
verkstadssnickare	verkstad	s	snickare
verkställare	verkställa	are
verktygsmaskin	verktyg	s	maskin
vetebröd	vete	bröd
vetebulle	vete	bulle
vetemjöl	vete	mjöl
vetenskaplig	vetenskap	lig
vetenskapligt	vetenskaplig	t
vetenskapsakademi	vetenskap	s	akademi
vetenskapsgren	vetenskap	s	gren
vetenskapshistoria	vetenskap	s	historia
vetenskapshistoriker	vetenskap	s	historiker
vetenskapsjournalist	vetenskap	s	journalist
vetenskapskommunikatör	vetenskap	s	kommunikatör
vetenskapskvinna	vetenskap	s	kvinna
vetenskapsteoretiskt	vetenskapsteoretisk	t
veterinärhögskola	veterinär	högskola
veterinärmottagning	veterinär	mottagning
veterinärstudent	veterinär	student
vickning	vicka	ning
vidareutbildning	vidareutbilda	ning
vidareutveckling	vidareutveckla	ing
videobutik	video	butik
videopitch	video
videopresentation	video
vidimering	vidimera	ing
vigselring	vigsel	ring
vikare	vika	are
viktig	vikt	ig
viktnedgång	vikt	nedgång
vildhäst	vild	häst
vildsvinskött	vildsvin	s	kött
villaförort	villa	förort
villaområde	villa	område
villasamhälle	villa	samhälle
villaträdgård	villa	trädgård
villaägare	villa	ägare
viloläge	vila	läge
vindkraftverk	vind	kraftverk
vindskydd	vind	skydd
vindskärm	vind	skärm
vinflaska	vin	flaska
vingård	vin	gård
vinkanna	vin	kanna
vinkning	vinka	ning
vinnare	vinna	are
vinning	vina	ning
vinområde	vin	område
vinproducent	vin	producent
vinstchans	vinst	chans
vinstintresse	vinst	intresse
vinstutdelning	vinst	utdelning
vinterbad	vinter	bad
vinterbostad	vinter	bostad
vinterdäck	vinter	däck
vinterkläder	vinter	kläder
vinternatt	vinter	natt
vinterpotatis	vinter	potatis
vinterresa	vinter	resa
vintersport	vinter
vinterväg	vinter	väg
vinöppnare	vin	öppnare
virkning	virka	ning
virusfri	virus
virusinfektion	virus	infektion
virussjukdom	virus	sjukdom
virusskanner	virus	skanner
visare	visa	are
vishet	vis	het
visitering	visitera	ing
viskning	viska	ning
visning	visa	ning
visningslägenhet	visning	s	lägenhet
vispning	vispa	ning
visualisering	visualisera	ing
visuellt	visuell	t
vithet	vit	het
vitkålssoppa	vitkål	s	soppa
vitlöksklyfta	vitlök	s	klyfta
vitlökspulver	vitlök	s	pulver
vitlökssmör	vitlök	s	smör
vittnesbörd	vittne	s	börd
vokalkvalitet	vokal	kvalitet
vokalljud	vokal	ljud
volontärarbeta	volontär	arbeta
volymmässig	volym	mässig
votering	votera	ing
vresigt	vresig	t
vridbar	vrida	bar
vridning	vrida	ning
vräkning	vräka	ning
vräkningsdag	vräkning	s	dag
vulkanutbrott	vulkan	utbrott
väckare	väcka	are
väderkarta	väder	karta
väderkvarn	väder	kvarn
väderlek	väder	lek
väderlåda	väder	låda
väderprognos	väder	prognos
vägarbetare	väg	arbetare
vägavgift	väg	avgift
väggklocka	vägg	klocka
vägkarta	väg	karta
vägledare	väg	ledare
vägledning	vägleda	ning
vägmärke	väg	märke
vägområde	väg	område
vägprojekt	väg	projekt
vägrare	vägra	are
vägsträckning	väg	sträckning
väjning	väja	ning
väldigt	väldig	t
välgörenhetsfond	välgörenhet	s	fond
välgörenhetsorganisation	välgörenhet	s	organisation
väljare	välja	are
välståndsindikator	välstånd	s	indikator
vändning	vända	ning
vänlig	vän	lig
vänlös	vän	lös
vänskapsförbindelse	vänskap	s	förbindelse
vänskapsmatch	vänskap	s	match
vänsterextrem	vänster	extrem
vänsterextremist	vänsterextrem	ist
vänsterpartist	vänster
vänstersekt	vänster	sekt
värdegrund	värd	e	grund
värdegrundsfråga	värdegrund	s	fråga
värdelös	värde	lös
värdemässig	värde	mässig
värdera	värd	era
värdering	värdera	ing
värderingsutlåtande	värdering	s	utlåtande
värdig	värd	ig
värdighet	värdig	het
världshav	värld	hav
världskarta	värld	s	karta
världsman	värld	s	man
världsmästare	värld	s	mästare
världspolitik	värld	s	politik
världspopulation	värld	population
världsrekordförsök	världsrekord	försök
världsutställning	värld	s	utställning
världsålder	värld	s	ålder
värnplikt	värn	plikt
värnpliktig	värnplikt	ig
värvare	värva	are
värvning	värva	ning
väsning	väsa	ning
västkust	väst	kust
västlig	väst	lig
vävare	väva	are
vävnad	väva	nad
växelkurs	växel	kurs
växelvis	växel	vis
växling	växla	ing
växtblindhet	växt	blindhet
växthus	växt	hus
växthuseffekt	växthus	effekt
växthusgas	växthus	gas
växtkött	växt	kött
växtsjukdom	växt	sjukdom
växttråd	växt	tråd
våffeljärn	våffla	järn
våffelsmet	våffla	smet
våldsam	våld	sam
våldsamhet	våldsam	het
våldshandling	våld	s	handling
våldtäkt	våld	täkt
våldtäktsrättegång	våldtäkt	rättegång
våningssäng	våning	s	säng
vårdare	vårda	are
vårdbidrag	vård	bidrag
vårdföretag	vård	företag
vårdförsäkring	vård	försäkring
vårdgivare	vård	givare
vårdnad	vårda	nad
vårdnadsersättning	vårdnad	s	ersättning
vårdplats	vård	plats
vårdskada	vård	skada
vårdskuld	vård	skuld
vårdteam	vård	team
vårväxt	vår	växt
wallraffning	wallraffa	ning
webbadministratör	webb	administratör
webbadress	webb	adress
webbanalytiker	webb	analytiker
webbdesign	webb	design
webbhotell	webb	hotell
webbkamera	webb	kamera
webbproducent	webb	producent
webbprogrammerare	webb	programmerare
webbprogrammering	webb	programmering
webbredaktör	webb	redaktör
webbriktlinje	webb	riktlinje
webbseminarium	webb	seminarium
webbserver	webb	server
webbtidning	webb	tidning
webbtjänst	webb	tjänst
webbutvecklare	webb	utvecklare
webbutveckling	webb	utveckling
ymnigt	ymnig	t
ympning	ympa	ning
yngling	yngla	ing
yrkesarbetare	yrkesarbeta	are
yrkeserfarenhet	yrke	s	erfarenhet
yrkesförare	yrke	s	förare
yrkesförbrytare	yrke	s	förbrytare
yrkeshögskoleutbildning	yrkeshögskola	utbildning
yrkeskategori	yrke	s	kategori
yrkeslegitimation	yrke	s	legitimation
yrkesmilitär	yrke	s	militär
yrkesmässigt	yrkesmässig	t
yrkesperson	yrke	s	person
yrkesutbildning	yrke	utbildning
yrkesverksamhet	yrkesverksam	het
ytlig	yta	lig
yttrandefrihet	yttrande	frihet
yttring	yttra	ing
yxmörda	yxa	mörda
zombiebrand	zombie	brand
zonkarta	zon	karta
zucchinibiff	zucchini	biff
äckelgubbe	äckel	gubbe
ägare	äga	are
äggcell	ägg	cell
äggfri	ägg	fri
äggmacka	ägg	macka
äggmjölk	ägg	mjölk
äggpackeri	ägg	packeri
äggstocksinflammation	äggstock	s	inflammation
äktenskapsvåldtäkt	äktenskap	våldtäkt
älgkött	älg	kött
älskare	älska	are
ämbetsmannafamilj	ämbetsman	na	familj
ämnesexpert	ämne	s	expert
ämneskompetens	ämne	s	kompetens
ändamålsenlighet	ändamålsenlig	het
ändring	ändra	ing
ängsligt	ängslig	t
ärekränkning	ärekränka	ning
ärmlös	ärm	lös
ätare	äta	are
äventyrare	äventyra	are
åhörare	åhöra	are
åkare	åka	are
ålderdomlig	ålderdom	lig
ålderdomligt	ålderdomlig	t
ålderman	ålder	man
åldersbestämma	ålder	s	bestämma
åldersutlåtande	ålder	s	utlåtande
åldringshem	åldring	s	hem
ångare	ånga	are
årlig	år	lig
årsmedeltemperatur	år	medeltemperatur
årsmodell	år
årsvis	år	s	vis
årtusende	år	tusende
återanpassa	åter	anpassa
återanställa	åter	anställa
återanvända	åter	använda
återberätta	åter	berätta
återbesöka	åter	besöka
återbetala	åter	betala
återbetalning	återbetala	ning
återblogga	åter	blogga
återbruka	åter	bruka
återdesigna	åter	designa
återfalla	åter	falla
återfinna	åter	finna
återfå	åter	få
återföra	åter	föra
återförena	åter	förena
återge	åter	ge
återgiva	åter	giva
återgivning	återgiva	ning
återgå	åter	gå
återhämta	åter	hämta
återinföra	åter	införa
återinsjukna	åter	insjukna
återinviga	åter	inviga
återkalla	åter	kalla
återkallad	åter	kallad
återkomma	åter	komma
återlämna	åter	lämna
återse	åter	se
återskapa	åter	skapa
återspegla	åter	spegla
återspegling	återspegla	ing
återstarta	åter	starta
återställa	åter	ställa
återställare	återställa	are
återställning	återställa	ning
återstå	åter	stå
återta	åter	ta
återuppbyggnad	återuppbygga	nad
återuppleva	åter	uppleva
återuppstå	åter	uppstå
återuppta	åter	uppta
återupptäcka	åter	upptäcka
återvinna	åter	vinna
återvinning	åter	vinning
återvinningsanläggning	återvinning	s	anläggning
återvinningscentral	återvinning	s	central
återvinningsstation	återvinning	s	station
återvälja	åter	välja
återvända	åter	vända
åtskilja	åt	skilja
ögrupp	ö	grupp
ökenspridning	öken	spridning
ökning	öka	ning
ömsesidigt	ömsesidig	t
önsketanke	tanke
önskning	önska	ning
öppenhet	öppen	het
öppnare	öppna	are
örlogsfartyg	örlog	s	fartyg
örlogsflotta	örlog	s	flotta
örlogsstation	örlog	s	station
örtig	ört	ig
överarbeta	över	arbeta
överarkitekt	över	arkitekt
överbefälhavare	över	befälhavare
överbelasta	över	belasta
överbevisa	över	bevisa
överbibliotekarie	över	bibliotekarie
överblick	över	blick
överblicka	över	blicka
överblickbar	överblicka	bar
överbliven	över	bliven
överbyggnad	över	byggnad
överdirektör	över	direktör
överdomstol	över	domstol
överdos	över
överdosera	över	dosera
överdosering	över	dosering
överdrift	över	drift
överdriva	över	driva
överdriven	över	driven
överdödlighet	över	dödlighet
överexponera	över	exponera
överexponering	över	exponering
överfalla	över	falla
överfart	över	fart
överflygning	över	flygning
överflödig	överflöd	ig
överfurir	över	furir
överfärd	över	färd
överföra	över	föra
överförbar	överföra	bar
överföring	överföra	ing
överförmyndare	över	förmyndare
överge	över	ge
övergiva	över	giva
övergiven	över	given
övergrepp	över	grepp
övergripande	över	gripande
övergå	över	gå
övergång	över	gång
överhovmästarinna	över	hovmästarinna
överhus	över	hus
överhuvud	över	huvud
överingenjör	över	ingenjör
överklaga	över	klaga
överklass	över	klass
överkokt	över	kokt
överkropp	över	kropp
överkurs	över	kurs
överlappa	över	lappa
överlappning	överlappa	ning
överleva	över	leva
överleverera	över	leverera
överlevnad	överleva	nad
överlista	över	lista
överlägga	över	lägga
överläggning	över	läggning
överläkare	läkare
överlämna	över	lämna
överlämning	över	lämning
överlärare	över	lärare
överlåta	över	låta
överlåtare	överlåta	are
övermänniska	över	människa
övernatta	över	natta
övernattning	övernatta	ning
överraskning	överraska	ning
överrepresentation	över	representation
överresa	över	resa
överrock	över	rock
överrösta	över	rösta
överse	över
översida	över	sida
översikt	över	sikt
överskatta	över	skatta
överskott	över	skott
överskrida	över	skrida
överskrift	över	skrift
överskärning	över	skärning
överspel	över	spel
överstatlig	över	statlig
överstiga	över	stiga
överstyrelse	över	styrelse
översyn	över	syn
översätta	över	sätta
översättare	översätta	are
översättning	över	sättning
översättningsfel	översättning	s	fel
överta	över	ta
övertala	över	tala
övertalning	övertala	ning
övertandläkare	över	tandläkare
övertolka	över	tolka
överton	över	ton
överträffa	över
övervaka	över	vaka
övervakare	övervaka	are
övervakning	över	vakning
övervakningsekonomi	övervakning	s	ekonomi
övervikt	över	vikt
överviktig	över	viktig
övervinna	över	vinna
övervärdera	över	värdera
övervåning	över	våning
överåklagare	över	åklagare
övning	öva	ning
övningskörning	övningsköra	ning
